ab=ably
abandon=abandon
abas=abasement
abat=abate
abdic=abdication
abey=abeyance
abhor=abhorrent
abid=abiding
abil=ability
abject=abject
abl=able
ablaz=ablaze
ablut=ablutions
abneg=abnegation
abod=abode
abolish=abolished
abomin=abomination
aborigin=aboriginal
abort=abortive
abound=abounding
abov=above
abovecit=above‑cited
abovequot=above‑quoted
abridg=abridged
abroad=abroad
abrog=abrogated
abrupt=abruptly
absent=absence
absolut=absolute
absorb=absorbed
abstain=abstain
abstract=abstract
abstrus=abstruse
absurd=absurd
abus=abuse
abyss=abyss
academ=academic
acced=acceded
accel=accelerated
accent=accents
accentu=accentuated
accept=accept
access=access
accession=accession
accessor=accessories
accid=accidental
acclaim=acclaimed
accolad=accolades
accommod=accommodate
accompan=accompanied
accomplic=accomplice
accomplish=accomplished
accord=according
account=account
accredit=accredited
accumul=accumulated
accur=accurate
accus=accusations
achiev=achieved
acknowledg=acknowledge
acquaint=acquainted
acquiesc=acquiescence
acquir=acquire
acquit=acquitted
acr=acre
across=across
act=act
action=action
active=active
activity=activities
actor=actors
actual=actually
actuat=actuated
acut=acute
ad=added
adam=adam
adamant=adamant
adamantin=adamantine
adapt=adapt
add=add
addict=addiction
addit=addition
address=addressed
adduc=adduced
adept=adept
adequ=adequately
adh=adherents
adjac=adjacent
adjoin=adjoining
adjud=adjudicate
adjunct=adjunct
adjur=adjure
adjust=adjustments
administ=administrative
admir=admiration
admit=admit
admix=admixture
admonish=admonitions
adolesc=adolescence
adopt=adopted
ador=adoration
adorn=adorned
adult=adults
adulter=adultery
advanc=advance
advantag=advantage
advent=advent
adventur=adventure
advers=adversaries
advert=advertised
advis=advice
advoc=advocate
aeroplan=aeroplanes
afar=afar
aff=affiliation
affair=affairs
affect=affected
affectation=affectation
affection=affection
affin=affinity
affirm=affirms
affix=affix
afflict=afflictions
affluent=affluence
afford=afford
affright=affrighted
affront=affront
afield=afield
afir=afire
aflam=aflame
afloat=afloat
afor=afore
aforement=aforementioned
aforetim=aforetime
afraid=afraid
afresh=afresh
africa=africa
aft=after
aftermath=aftermath
afternoon=afternoon
afterward=afterwards
against=against
age=age
agelong=age‑long
agency=agencies
agenda=agenda
agent=agents
ageold=age‑old
aggrand=aggrandisement
aggrav=aggravate
aggreg=aggregate
aggress=aggression
aggriev=aggrieved
agit=agitation
aglow=aglow
agnost=agnostics
ago=ago
agon=agony
agre=agreement
agricultur=agriculture
ahead=ahead
aid=aid
ail=ailing
ailment=ailments
aim=aim
air=air
akin=akin
al=allied
ala=alas
alacr=alacrity
alarm=alarm
albeit=albeit
alchem=alchemy
alcohol=alcohol
alert=alert
alien=alien
align=align
alik=alike
aliv=alive
allamerica=all‑america
allay=allay
allbount=all‑bountiful
allcompel=all‑compelling
allconqu=all‑conquering
alleg=allegations
allegi=allegiance
allegor=allegorical
allembrac=all‑embracing
allencircl=all‑encircling
allencompass=all‑encompassing
allenfold=all‑enfolding
allev=alleviate
allforgiv=all‑forgiving
allgen=all‑generous
allglor=all‑glorious
allglorif=all‑glorified
allhear=all‑hearing
allhigh=all‑highest
allinclus=all‑inclusive
allinform=all‑informed
allknow=all‑knowing
alllov=all‑loving
allmerc=all‑merciful
alloc=allocated
allot=allotted
allow=allow
allperceiv=all‑perceiving
allpervad=all‑pervading
allpervas=all‑pervasive
allpossess=all‑possessing
allpow=all‑powerful
allprais=all‑praised
allse=all‑seeing
allsubdu=all‑subduing
allsuff=all‑sufficing
allsway=all‑swaying
allud=alluded
allunif=all‑unifying
allur=allurements
allus=allusions
allwis=all‑wise
alm=alms
almost=almost
almsbowl=alms‑bowl
aloft=aloft
alon=alone
along=along
alongsid=alongside
aloof=aloof
aloud=aloud
alpha=alpha
alphabet=alphabet
alread=already
also=also
alt=altered
altar=altar
altern=alternative
although=although
altogeth=altogether
altruism=altruistic
alway=always
amanuens=amanuensis
amass=amassed
amaz=amazing
ambassador=ambassador
ambergr=ambergris
ambit=ambitious
ambush=ambush
amelior=amelioration
amen=amenities
amend=amends
america=american
amid=amidst
amit=amity
ammunit=ammunition
among=among
amount=amount
ampl=ample
amput=amputated
amus=amusement
analog=analogy
analys=analysis
anarch=anarchy
anathemat=anathemas
anatom=anatomy
ancestor=ancestral
anchor=anchor
ancient=ancient
ang=anger
angel=angels
angl=angle
anglican=anglicans
angr=angry
anguish=anguish
anim=animating
animal=animal
animalism=animalistic
animator=animators
animos=animosity
animus=animus
annal=annals
annihil=annihilation
anniversar=anniversary
annot=annotated
announc=announced
annual=annual
annul=annulled
anoint=anointed
anomal=anomalous
anoth=another
answ=answer
ant=ant
antagon=antagonism
anthem=anthems
anthropogen=anthropogenic
anti=anti
antichrist=antichrist
anticip=anticipated
anticl=anticlericalism
antidot=antidote
antipath=antipathy
antipod=antipodes
antiqu=antiquated
antithes=antithesis
anxiet=anxiety
anxious=anxious
anybod=anybody
anyon=anyone
anyth=anything
apar=apart
apart=apartments
apath=apathy
ape=ape
apex=apex
apocalyps=apocalypse
apolog=apologies
apost=apostate
apostl=apostle
apostroph=apostrophe
app=apply
appal=appalling
appar=apparent
apparel=apparel
appeal=appeal
appear=appeared
appeas=appease
appel=appellation
appendix=appendix
appertain=appertaining
appetit=appetites
appl=apple
applaud=applaud
applic=application
applicable=applicable
appoint=appointed
apprais=appraise
apprec=appreciate
apprehend=apprehend
apprehens=apprehension
appris=apprised
approach=approach
appropr=appropriated
appropriate=appropriate
approv=approved
approxim=approximately
apt=apt
aptitud=aptitude
ar=arrest
arab=arabic
arabia=arabian
arbit=arbitration
arbitrar=arbitrary
arc=arc
arcad=arcade
arch=arch
archbishop=archbishops
archbreak=arch‑breaker
archdeacon=archdeacon
archduchess=arch‑duchess
archduk=archduke
archenem=arch‑enemy
architect=architect
archiv=archives
arctic=arctic
ardent=ardent
ardour=ardour
arduous=arduous
area=area
arena=arena
argu=arguments
arid=arid
aries=aries
aright=aright
aris=arise
aristocrat=aristocratic
aristotl=aristotle
ark=ark
arm=army
armband=armbands
armour=armour
around=around
arous=aroused
arraign=arraignment
arrang=arrangements
array=arrayed
arrest=arrested
arriv=arrived
arrog=arrogant
arrogat=arrogate
arrow=arrows
arsenal=arsenal
arson=arson
art=arts
arter=arteries
articl=articles
artific=artificial
artisan=artisans
artt=art
ascend=ascension
ascertain=ascertain
ascet=asceticism
ascrib=ascribed
asean=asean
ash=ashes
asham=ashamed
ashin=ashine
ashor=ashore
asia=asia
asid=aside
ask=asked
asleep=asleep
asp=asp
aspect=aspects
aspir=aspirations
ass=ass
assail=assailed
assassin=assassination
assault=assaults
assay=assayer
assembl=assemblies
assent=assent
assert=assertion
assess=assess
asset=assets
assidu=assiduously
assign=assigned
assimil=assimilated
assist=assist
assistant=assistants
assoc=associated
assum=assume
assur=assured
astir=astir
astonish=astonishing
astound=astounding
astray=astray
astronom=astronomer
astut=astute
asund=asunder
asylum=asylum
at=attest
ate=ate
atheism=atheists
athirst=athirst
atlant=atlantic
atmosph=atmosphere
atom=atom
aton=atone
atroc=atrocities
attach=attachment
attack=attacks
attain=attain
attempt=attempt
attend=attend
attent=attention
attest=attested
attir=attire
attitud=attitude
attorney=attorney
attorneygen=attorney‑general
attract=attracted
attribut=attributes
attun=attuned
auction=auctioned
audac=audacity
audient=audience
audio=audio
audiovisu=audiovisual
auditorium=auditorium
aught=aught
augment=augmented
augur=augur
august=august
aunt=aunts
auspic=auspicious
aust=austerity
australasia=australasia
authent=authentic
author=author
authoris=authorised
authorit=authority
autocrat=autocracy
automat=automatically
autonom=autonomy
autumn=autumn
auxiliar=auxiliary
av=avers
avail=avail
availa=available
avaric=avarice
avatar=avatar
aveng=avenging
avenu=avenues
averag=average
avers=aversion
avert=avert
avid=avid
avoid=avoid
avow=avowed
aw=awful
await=await
awak=awakened
awar=aware
award=awarded
away=away
awe=awe
aweinspir=awe‑inspiring
awhil=awhile
ax=axis
axe=axe
baby=babe
back=back
backbit=backbiting
backdrop=backdrop
background=background
backward=backward
bad=bad
bade=bade
balant=balance
bale=baleful
ball=ball
ballot=ballot
balm=balm
balustrad=balustrades
ban=ban
band=band
bane=baneful
banish=banishment
bank=banks
bankrupt=bankruptcy
bann=banner
banquet=banquet
baptis=baptised
bar=barred
barbar=barbarous
bare=bare
barefoot=bare‑footed
bargain=bargaining
bark=bark
barley=barley
barn=barn
baron=baroness
barr=barriers
barrack=barracks
barracksquar=barrack‑square
barren=barren
barricad=barricades
bart=barter
bas=basis
base=based
basement=basement
basic=basic
bask=bask
basket=baskets
bastinado=bastinado
bat=bats
bath=bath
batlik=bat‑like
battalion=battalions
batter=battered
battl=battle
battle=battlefield
battleship=battleships
bay=bay
bayonet=bayoneted
bazaar=bazaars
be=being
beam=beaming
bear=bear
beard=beard
beast=beasts
beat=beat
beaut=beauty
becam=became
beckon=beckons
becloud=becloud
becom=become
bed=bed
bedazzl=bedazzled
bedevil=bedevil
bedrock=bedrock
bedsid=bedside
beetl=beetle
befal=befallen
befit=befitting
befool=befooled
befor=before
beg=beg
began=began
begem=begemmed
beggar=beggar
begin=beginning
beguil=beguile
begun=begun
behalf=behalf
behav=behaviour
behe=behest
behead=beheaded
behind=behind
behold=behold
behov=behoveth
beleagu=beleaguered
believ=believers
belittl=belittle
bell=bells
belong=belong
belov=beloved
below=below
belt=belt
bemoan=bemoan
bend=bend
beneath=beneath
benedict=benediction
benefact=benefactor
benefic=beneficent
beneficiar=beneficiaries
benefit=benefit
benevol=benevolent
benight=benighted
bent=bent
bequ=bequest
bequeath=bequeathed
bereav=bereaved
bereft=bereft
beseech=beseech
beseem=beseemeth
beset=beset
besid=besides
besieg=besieged
besought=besought
best=best
bestbelov=best‑beloved
bestinform=best‑informed
bestir=bestir
bestow=bestowals
betak=betook
betid=betide
betoken=betokeneth
betray=betrayal
bett=better
beturban=beturbaned
between=between
betwixt=betwixt
beverag=beverages
bewail=bewail
bewar=beware
bewild=bewildered
bewitch=bewitched
beyond=beyond
bias=bias
bibl=bible
bibliograph=bibliography
bicentenar=bicentenary
bick=bickerings
bid=bidden
big=big
bigam=bigamy
bigot=bigotry
billion=billion
billow=billows
bind=binding
biolog=biological
bird=birds
birth=birth
birthday=birthdays
birthpang=birth‑pangs
birthright=birthright
bishop=bishops
bite=biting
bitt=bitter
black=black
blackey=black‑eyed
blade=blade
blam=blame
blameworth=blameworthy
blasphem=blasphemy
blast=blast
blatant=blatant
blaze=blaze
blend=blended
bless=blessed
blight=blight
blind=blind
bliss=blissful
bloc=bloc
block=block
blood=blood
blooddrench=blood‑drenched
bloodsh=bloodshed
bloodstain=blood‑stained
bloodthirst=bloodthirsty
bloom=bloom
blossom=blossoms
blot=blotted
blow=blow
blue=blue
blunt=blunted
blush=blush
board=board
boast=boast
boat=boat
bod=body
bodyguard=bodyguard
bog=bogged
boil=boiling
bold=bold
bolst=bolstered
bolt=bolts
bomb=bomb
bombard=bombardment
bombshel=bomb‑shells
bond=bond
bondag=bondage
bondsmen=bondsmen
bone=bone
book=book
boon=boon
boost=boost
bord=borders
born=born
borrow=borrow
bosom=bosom
both=both
bottom=bottom
bough=bough
bound=bound
boundar=boundaries
bounden=bounden
bount=bounty
bourgeo=bourgeois
bow=bow
bowel=bowels
bower=bowers
bowl=bowl
box=box
boy=boys
brace=brace
braill=braille
brain=brain
brais=braised
brambl=brambles
branch=branch
brand=branded
brass=brass
brasslik=brass‑like
breach=breach
bread=bread
breadth=breadth
breadwinn=breadwinners
break=broken
breakdown=breakdown
breakfast=breakfast
breakthrough=breakthrough
breast=breast
breath=breath
breathtak=breathtaking
breed=breed
breez=breezes
brethren=brethren
brew=brewing
bribe=bribery
bride=bride
bridg=bridge
brief=brief
brigand=brigands
bright=bright
brilliant=brilliant
brim=brimming
bring=bring
brink=brink
broad=broad
broadcast=broadcast
brocad=brocade
broid=broidered
brokenwing=broken‑winged
brooch=brooch
brook=brook
broth=brother
brotherinlaw=brother‑in‑law
brought=brought
brow=brow
brown=brown
brush=brushed
brute=brutal
bubbl=bubble
buckl=buckle
bud=bud
buddha=buddha
budget=budget
buffalo=buffalo
buffet=buffeted
bugl=bugle
build=building
bulk=bulk
bullet=bullets
bulletin=bulletins
bulwark=bulwark
bur=buried
burden=burden
bureau=bureau
bureaucrat=bureaucratic
burial=burial
burialground=burial‑ground
burialplac=burial‑place
burn=burning
burst=burst
bush=bush
busi=business
butch=butchery
buttress=buttressed
buy=bought
bye=bye
byelect=by‑election
bygon=bygone
bylaw=by‑laws
bystand=bystanders
cabinet=cabinet
cabl=cable
cage=cage
cal=call
calam=calamities
calcul=calculated
calendar=calendar
calf=calf
caliph=caliphate
calligraph=calligraphic
callous=callous
calm=calm
calumn=calumnies
came=came
camel=camel
camera=camera
camp=camp
campaign=campaign
camphor=camphor
canal=canalise
canc=cancer
cancel=cancel
cand=candy
candid=candid
candidat=candidates
candl=candle
candour=candour
cannon=cannon
cannot=cannot
canon=canonical
canop=canopy
canst=canst
capabl=capable
capac=capacity
capacitybuild=capacity‑building
capital=capital
capitalist=capitalism
capric=capricious
captain=captain
captiv=captive
captivat=captivated
captur=capture
car=car
caravan=caravan
caravansera=caravanserai
carcass=carcass
card=cards
cardin=cardinal
care=care
career=career
carnag=carnage
carnal=carnal
carnivor=carnivorous
carpet=carpet
carr=carried
carriag=carriage
carrion=carrion
carv=carved
case=case
cash=cash
casket=casket
cassett=cassette
cast=cast
caste=caste
castl=castle
cataclysm=cataclysmic
catalogu=catalogue
catalyst=catalyst
catastroph=catastrophic
catch=catch
categor=categories
cater=catering
cathol=catholic
caught=caught
cauldron=cauldron
caus=caused
caution=caution
cave=cave
cavil=cavilled
caw=cawing
ceas=cease
cede=ceded
celebr=celebrated
celest=celestial
cell=cell
cellular=cellular
cement=cement
cemet=cemetery
censorship=censorship
censur=censure
census=census
cent=cent
centenar=centenary
centr=centre
centur=century
centuryold=century‑old
ceremon=ceremony
certain=certain
certif=certificates
cessat=cessation
cetera=cetera
chain=chains
chair=chair
chairperson=chairman
chalic=chalice
challeng=challenge
chamb=chamber
champion=champion
championbuild=champion‑builders
chanc=chance
chang=change
channel=channels
chant=chant
chao=chaos
chapt=chapter
char=charred
charact=character
charg=charge
charit=charity
charm=charm
charter=charter
chase=chase
chast=chastity
chasten=chastisement
che=cheer
check=check
cheek=cheek
chemic=chemical
chemist=chemist
chequ=chequered
cherish=cherished
chief=chief
chil=chilled
child=children
childish=childish
chill=chill
chimney=chimney
choic=choice
choir=choir
cholera=cholera
choos=chosen
choreograph=choreographed
christ=christ
christian=christian
christma=christmas
christprom=christ‑promised
chronic=chronic
chronicl=chronicler
chrysolit=chrysolite
church=church
churchman=churchman
churchstat=church‑state
circl=circle
circul=circulated
circular=circular
circumpolar=circumpolar
circumscrib=circumscribed
circumspect=circumspection
circumst=circumstances
cit=city
citadel=citadel
cite=cite
citizen=citizens
cityst=city‑state
civil=civil
civilisation=civilisation
clad=clad
claim=claim
clamour=clamour
clan=clan
clandestin=clandestine
clarif=clarification
clarion=clarion
clarioncal=clarion‑call
clash=clash
clasp=clasp
class=classes
classic=classical
classif=classified
claw=claws
clay=clay
clean=cleanliness
cleans=cleanse
clear=clear
clearant=clearance
clearcut=clear‑cut
clearvis=clear‑visioned
cleav=cleave
clerg=clergy
cleric=clerics
client=clients
climat=climate
climax=climax
climb=climb
clime=climes
cling=cling
clinic=clinics
cloak=cloak
clock=clocks
clod=clod
clog=clog
cloist=cloisters
clos=closer
close=close
cloth=clothed
cloud=clouds
club=clubs
clung=clung
clust=cluster
clutch=clutches
coal=coal
coars=coarse
coast=coast
cochair=cochair
cock=cock
cockatric=cockatrice
code=codification
coequal=coequal
coerc=coercion
coexist=coexist
coff=coffers
coffin=coffin
cogent=cogent
cognis=cognisant
coh=coherence
cohes=cohesion
cohort=cohorts
coil=coils
coin=coin
coincid=coincide
cold=cold
collabor=collaboration
collaborator=collaborators
collaps=collapse
collar=collar
collat=collation
collater=collateral
colleagu=colleagues
collect=collective
colleg=colleges
collyrium=collyrium
colon=colony
colonel=colonel
colonnad=colonnade
coloss=colossal
colour=colour
column=columns
combat=combat
combin=combined
come=come
comfort=comfort
comingofag=coming‑of‑age
command=command
commanderinchief=commander‑in‑chief
commemor=commemoration
commenc=commencement
commensur=commensurate
comment=comments
commentar=commentary
commerc=commerce
commingl=commingling
commiss=commission
commit=committed
committe=committee
common=common
commonwealth=commonwealth
commot=commotion
commune=commune
communic=communication
communion=communion
communist=communism
communit=community
communitybuild=community‑building
comp=comply
compact=compact
compan=company
companion=companions
compar=compared
compass=compassed
compassion=compassionate
compat=compatible
compatriot=compatriots
compel=compelling
compens=compensate
compet=competent
compil=compilation
complac=complacency
complain=complaint
complement=complementary
complet=complete
complex=complex
compliant=compliance
complic=complications
compon=component
compos=composition
composur=composure
compound=compounded
comprehend=comprehend
compris=comprising
comprom=compromise
compulsor=compulsory
compunct=compunction
comput=computation
comrad=comrades
con=con
conc=conciliation
conceal=concealed
conceit=conceit
conceiv=conceived
concentr=concentrate
concept=concepts
conception=conception
conceptu=conceptual
concern=concerning
concert=concerted
conclav=conclave
conclud=conclusion
concoct=concocted
concomit=concomitant
concord=concord
concours=concourse
concret=concrete
concubin=concubinage
concupisc=concupiscent
concur=concurrently
condemn=condemned
condign=condign
condit=conditions
condol=condolences
condon=condone
conduc=conducive
conduct=conduct
conf=conferred
confed=confederate
conference=conference
confess=confess
confid=confidence
confin=confined
confirm=confirmations
confisc=confiscated
conflagr=conflagration
conflict=conflict
conform=conformity
confound=confounded
confront=confronted
confus=confusion
confut=confute
congratul=congratulate
congreg=congregation
congress=congress
conjectur=conjecture
conjoin=conjoined
conjunct=conjunction
conjur=conjured
connect=connection
conniv=connivance
connot=connote
conqu=conquest
conscient=conscience
conscious=consciousness
consecr=consecrated
consensus=consensus
consent=consent
consequ=consequences
conserv=conservation
consid=consider
consign=consigned
consist=consists
consol=consolation
consolid=consolidation
consort=consort
conspicu=conspicuous
conspir=conspired
constabl=constable
constant=constant
constel=constellation
constern=consternation
constitu=constituent
constitut=constitute
constitution=constitution
constrain=constrained
constru=construed
construct=construction
consul=consul
consulgen=consul‑general
consult=consultation
consum=consumed
consumm=consummation
cont=contest
contact=contact
contain=contained
contamin=contaminated
contempl=contemplate
contemporar=contemporary
contempt=contemptible
contend=contend
content=content
contenti=contentious
context=context
continent=continent
continentwid=continent‑wide
conting=contingent
continu=continue
continuum=continuum
contract=contract
contradict=contradiction
contrar=contrary
contrast=contrast
contribut=contribute
contrit=contrite
contriv=contrived
control=control
controvers=controversies
conven=convened
conveni=convenient
convent=convention
converg=converge
convers=conversation
convert=converted
convey=convey
convict=conviction
convinc=convinced
convok=convocation
convoy=convoy
convuls=convulsions
coo=cooing
cool=cool
coop=cooperation
coordin=coordinators
cop=copy
cope=cope
copious=copious
copp=copper
cord=cord
cordial=cordial
core=core
coreligionist=coreligionists
corner=corner
cornerston=cornerstone
corollar=corollary
corpor=corporeal
corps=corpse
corpul=corpulent
correct=correct
correl=correlate
correspond=correspondence
corridor=corridor
corrobor=corroborative
corrod=corrosive
corrupt=corrupt
corteg=cortege
cosmopolitan=cosmopolitan
cost=cost
cotton=cotton
couch=couch
couldst=couldst
council=councils
counsel=counsel
counsellor=counsellors
count=countless
counten=countenance
counter=counter
counteract=counteract
counterfeit=counterfeit
counterproduct=counterproductive
countr=country
countryman=countrymen
coupl=couple
courag=courage
cours=course
court=court
courteous=courtesy
courtyard=courtyard
cousin=cousin
cov=covered
coven=covenant
covenantbreak=covenant‑breakers
coverag=coverage
covert=covert
covet=covetous
cow=cow
coward=cowardly
cowork=coworkers
cr=cry
cradl=cradle
craft=crafts
crafti=crafty
craftsperson=craftsmen
crann=crannies
crass=crass
crawl=crawl
craze=crazed
creat=created
creation=creation
creativ=creative
creator=creator
creatur=creatures
credenti=credentials
credibl=credibility
credit=credit
credul=credulous
creed=creeds
creep=creeping
crept=crept
crescendo=crescendo
crest=crest
crew=crew
crime=crime
crimson=crimson
crimsoncolour=crimson‑coloured
crippl=crippled
cris=crisis
criterion=criterion
critic=critical
croak=croaking
crook=crooked
crop=crops
cross=cross
crossleg=cross‑legged
crosssect=cross‑section
crow=crow
crowd=crowded
crown=crown
crucial=crucial
crucibl=crucible
crucif=crucified
crude=crude
cruel=cruelty
crumbl=crumble
crusad=crusade
crush=crushed
cryptic=cryptic
crystal=crystal
cubic=cubic
culmin=culminating
cult=cult
cultiv=cultivate
cultur=culture
cumul=cumulative
cun=cunning
cup=cup
cupbear=cup‑bearer
cure=cure
curious=curiosity
curl=curling
curr=curry
currency=currency
current=current
currents=currents
curriculum=curriculum
curs=curse
cursor=cursory
curt=curt
curtail=curtailed
curtain=curtain
curv=curvature
custod=custody
custom=customs
cut=cut
cycl=cycle
cynic=cynicism
cypress=cypress
cypresstal=cypress‑tall
da=daily
dagg=dagger
damag=damage
damp=damp
dampen=dampen
damsel=damsel
danc=dance
dang=danger
dare=dare
dark=darkness
dart=darts
dash=dashed
data=data
date=dated
dateston=date‑stone
daught=daughter
daunt=dauntless
dawn=dawn
dawnbreak=dawn‑breakers
dawningplac=dawning‑place
dawningpoint=dawning‑point
day=day
daybreak=daybreak
dayspr=dayspring
daystar=daystar
daytim=daytime
daze=dazed
dazzl=dazzling
de=deer
dead=death
deaf=deaf
deal=deal
dear=dear
dearlybelov=dearly‑beloved
dearth=dearth
deathknel=death‑knell
deathpang=death‑pangs
debar=debarred
debas=debased
debat=debate
debauch=debauchery
debilit=debilitating
debt=debts
decad=decades
decadelong=decade‑long
decapit=decapitated
decay=decay
deceas=deceased
deceit=deceit
decemb=december
decent=decency
decentr=decentralisation
decept=deception
dechristian=de‑christianisation
decid=decide
decim=decimated
decis=decision
decisionmak=decision‑making
deck=decked
declar=declared
declin=decline
decompos=decomposition
decor=decoration
decre=decree
decreas=decreased
dedic=dedicated
deduc=deduced
deduct=deductions
deed=deeds
deem=deemed
deep=deep
deepen=deepening
def=deference
defam=defamatory
defeat=defeat
defect=defective
defend=defence
defi=defiance
defic=deficient
defil=defilement
defin=defined
deflect=deflect
defray=defrayed
degen=degenerate
degrad=degradation
degre=degree
deif=deifying
deject=dejected
delay=delay
deleg=delegates
delib=deliberations
delic=delicate
delight=delight
delin=delineated
delir=delirious
deliv=deliver
delud=delusion
delv=delve
demagog=demagogy
demand=demands
demeanour=demeanour
demis=demise
democrat=democratic
demolish=demolished
demon=demons
demonstr=demonstrate
demor=demoralised
den=den
deni=denied
denizen=denizens
denomin=denominations
denot=denote
denounc=denounced
dens=dense
denunc=denunciations
depart=department
depend=depend
depict=depict
deplor=deplorable
deploy=deployment
deport=deported
depos=deposed
deposit=deposited
deprav=depraved
depress=depression
depriv=deprived
depth=depths
deput=deputisation
derang=deranging
derid=derision
deriv=derive
dervish=dervish
descend=descend
describ=described
desecr=desecrated
desert=desert
desertdwel=desert‑dwellers
deserv=deserve
design=designed
desir=desire
desol=desolate
desp=desperate
despair=despair
despatch=despatched
despis=despised
despit=despite
despoil=despoiled
despond=despondency
despot=despotic
destin=destined
destitut=destitute
destroy=destruction
det=deter
detach=detachment
detail=details
detain=detained
detect=detected
detent=detention
deterior=deterioration
determin=determination
detest=detested
dethron=dethroned
detract=detract
detriment=detrimental
devast=devastating
develop=development
deviat=deviate
devic=devices
devis=devised
devoid=devoid
devolv=devolves
devot=devoted
devotional=devotional
devour=devour
devout=devout
dew=dew
dewdrop=dewdrop
diabol=diabolical
diadem=diadem
diagnos=diagnosed
dialogu=dialogue
diametr=diametrically
diamond=diamond
dichotom=dichotomies
dictat=dictates
didst=didst
die=died
diet=diet
diff=different
difficult=difficulties
diffus=diffused
dig=dig
dignif=dignity
dignitar=dignitaries
dilapid=dilapidated
dilemma=dilemma
dim=dimly
dimens=dimensions
diminish=diminish
diminut=diminution
din=din
diplomat=diplomatic
dire=dire
direct=direct
director=director
disabl=disabilities
disadvantag=disadvantaged
disagr=disagreement
disappear=disappear
disappoint=disappointment
disapprov=disapproval
disarm=disarmament
disast=disaster
disavow=disavow
disband=disbanded
disbeliev=disbelieved
disburs=disbursement
discard=discarded
discern=discern
discharg=discharge
discipl=disciples
disciplin=discipline
disclaim=disclaims
disclos=disclosed
disconcert=disconcerting
disconsol=disconsolate
discont=discontent
discord=discord
discourag=discouraged
discours=discourse
discov=discover
discredit=discredited
discreet=discretion
discrep=discrepancies
discrimin=discrimination
discuss=discussion
disdain=disdainfully
diseas=disease
disembark=disembarked
disencumb=disencumber
disendow=disendowed
disentangl=disentangle
disestablish=disestablishment
disfigur=disfigured
disgrac=disgrace
disguis=disguise
dishearten=disheartened
dishon=dishonesty
dishonour=dishonour
disillus=disillusioned
disinclin=disinclined
disint=disinter
disintegr=disintegration
disinterest=disinterested
disloc=dislocation
disloy=disloyalty
dismay=dismay
dismemb=dismemberment
dismiss=dismissed
dismount=dismounted
disobey=disobedience
disord=disorder
disorgan=disorganised
disown=disowned
dispar=disparity
disparag=disparagement
dispassion=dispassionately
dispatch=dispatched
dispel=dispelled
dispens=dispensation
dispensar=dispensary
dispers=dispersed
dispirit=dispirited
display=display
displeas=displeasure
disport=disporting
dispos=disposal
disposit=disposition
dispossess=dispossessed
disprov=disprove
disput=dispute
disquiet=disquieting
disregard=disregard
disreput=disrepute
disrupt=disruption
dissect=dissection
dissemin=dissemination
dissens=dissension
dissert=dissertations
dissimilar=dissimilarity
dissip=dissipated
dissoc=dissociated
dissolut=dissolution
dissolv=dissolved
dissuad=dissuade
distant=distant
distinct=distinction
distinguish=distinguished
distort=distortion
distract=distracted
distraught=distraught
distress=distress
distribut=distribution
district=district
distrust=distrust
disturb=disturbed
disun=disunity
disunion=disunion
disus=disuse
dive=divest
diverg=divergent
divers=diversity
diversif=diversified
divert=divert
divest=divested
divid=divided
divin=divine
divinelyappoint=divinely‑appointed
divinelyconceiv=divinely‑conceived
divis=division
divorc=divorce
divulg=divulged
do=doing
doctor=doctors
doctrin=doctrines
document=document
dodg=dodge
dog=dogs
dogma=dogmas
dollar=dollars
domain=domain
dome=dome
domest=domestic
domin=dominant
dominion=dominion
don=don
donat=donations
donkey=donkey
doom=doom
door=door
doorstep=doorstep
doorway=doorway
dormant=dormant
dost=dost
doth=doth
doubl=double
doubt=doubt
dove=dove
downfal=downfall
download=downloaded
downtrodden=downtrodden
dowr=dowry
dozen=dozen
dr=dry
draft=drafting
drag=dragged
dragon=dragon
drain=drained
drama=dramatic
drank=drank
drastic=drastic
draught=draught
draw=draw
dread=dreadful
dreadnought=dreadnoughts
dream=dream
drear=dreary
dreg=dregs
drench=drenched
dress=dress
driedup=dried‑up
drift=drift
drink=drink
drive=driven
droop=drooping
drop=drop
dross=dross
drug=drugs
drum=drums
drunk=drunk
du=duly
dual=dual
due=due
dug=dug
duke=duchess
dul=dulled
dull=dull
dullwit=dull‑witted
dumb=dumb
dumbfound=dumbfounded
dungeon=dungeon
dupe=duped
duplic=duplication
durabl=durable
durat=duration
dure=during
dust=dust
dustheap=dust‑heap
dut=duty
dwarf=dwarf
dwell=dwell
dwelling=dwelling
dwellingplac=dwelling‑place
dwelt=dwelt
dwindl=dwindling
dy=dyed
dynam=dynamic
dynamit=dynamite
dynast=dynasty
dysent=dysentery
dysfunct=dysfunctional
eag=eager
eagl=eagle
ear=ear
earli=early
earmark=earmarked
earn=earn
earnest=earnest
earth=earth
earthenwar=earthenware
earthquak=earthquake
earthwork=earthwork
eas=ease
east=east
eat=eat
eb=ebb
ebullit=ebullitions
ecclesiast=ecclesiastical
echo=echo
eclips=eclipse
ecolog=ecological
econom=economic
ecstas=ecstasy
edg=edge
edict=edict
edif=edification
edific=edifice
edit=edition
educ=education
effac=effaced
effect=effect
effective=effective
effet=effete
effic=efficient
efficac=efficacy
effloresc=efflorescence
effort=efforts
effulg=effulgence
effus=effusions
ego=ego
egress=egress
eight=eight
eighteen=eighteen
eighteenth=eighteenth
eighth=eighth
eightyf=eighty‑five
eightyon=eighty‑one
eith=either
eject=ejectment
elabor=elaborate
elaps=elapsed
elat=elated
eld=eldest
elect=elected
electr=electricity
electron=electronic
eleg=elegance
element=elements
eleph=elephant
elev=elevated
eleven=eleven
elicit=elicit
elig=eligible
elimin=eliminate
elit=elites
elixir=elixir
eloqu=eloquent
els=else
elsewh=elsewhere
elucid=elucidated
elud=elude
email=email
eman=emanate
emancip=emancipation
emb=embedded
embark=embarked
embarrass=embarrassing
embass=embassy
embattl=embattled
embellish=embellished
embitt=embittered
emblazon=emblazon
emblem=emblems
embod=embodiment
embolden=emboldened
embosom=embosomed
embrac=embrace
embroid=embroidery
embroil=embroilments
embryo=embryo
embryon=embryonic
emerald=emerald
emeraldgreen=emerald‑green
emerg=emergence
emeritus=emeritus
emigr=emigrated
emin=eminent
emissar=emissary
emot=emotions
emperor=emperor
emphas=emphasis
emphat=emphatic
empir=empire
employ=employed
empow=empowerment
empt=empty
emptyhand=empty‑handed
empyrean=empyrean
emul=emulate
enabl=enable
enact=enacted
enamour=enamoured
enchant=enchanting
encircl=encircling
enclos=enclosed
encomium=encomiums
encompass=encompassed
encount=encounter
encourag=encouraged
encrust=encrusted
end=end
endeavour=endeavour
endem=endemic
endors=endorsed
endow=endowed
endu=endued
endur=endure
enem=enemies
energ=energies
enerv=enervating
enfold=enfolded
enforc=enforce
engag=engaged
engend=engendered
engin=engine
english=english
engrav=engraved
engross=engrossed
engulf=engulfed
enhant=enhance
enjoin=enjoined
enjoy=enjoy
enkindl=enkindled
enlarg=enlarge
enlighten=enlightened
enlist=enlisted
enmesh=enmeshed
enmit=enmity
ennobl=ennobled
enorm=enormous
enough=enough
enraptur=enraptured
enrich=enrich
enrol=enrolled
enshrin=enshrined
ensign=ensign
enslav=enslaved
ensnar=ensnared
ensu=ensued
ensur=ensure
entail=entail
entangl=entangled
enter=enter
enterpr=enterprise
entertain=entertain
enthral=enthralling
enthus=enthusiasm
entir=entire
entit=entity
entitl=entitled
entomb=entombment
entourag=entourage
entr=entry
entranced=entrancing
entrap=entrapped
entreat=entreat
entrench=entrenched
entrust=entrusted
enum=enumerated
enunc=enunciated
env=envy
envelop=enveloped
environ=environment
environment=environmental
envis=envisaged
envoy=envoy
enwrap=enwrapped
ephem=ephemeral
epic=epic
epidem=epidemic
episod=episode
epistl=epistle
epoch=epoch
epochmak=epoch‑making
equal=equal
equation=equation
equator=equator
equilibr=equilibrium
equinox=equinox
equip=equipped
equit=equity
equival=equivalent
era=era
erad=eradication
eras=erased
ere=ere
erect=erection
erelong=erelong
erod=eroded
error=error
erudit=erudite
erupt=eruption
escap=escape
eschew=eschew
escort=escort
espec=especially
espionag=espionage
espous=espoused
essent=essential
establish=established
estat=estate
esteem=esteemed
estim=estimation
estrang=estrangement
etc=etc
etern=eternal
eth=ethereal
ethic=ethical
ethnic=ethnic
eulog=eulogy
eunuch=eunuch
europ=europe
evalu=evaluation
evanesc=evanescent
evas=evasion
even=even
evening=evening
event=events
eventid=eventide
eventu=eventually
ever=ever
everabid=ever‑abiding
everadv=ever‑advancing
everchang=ever‑changing
everdeepen=ever‑deepening
everexpand=ever‑expanding
everforgiv=ever‑forgiving
evergreat=ever‑greater
evergrow=ever‑growing
everincreas=ever‑increasing
everlast=everlasting
everliv=ever‑living
everpres=ever‑present
everrecur=ever‑recurring
eversolicit=ever‑solicitous
eversustain=ever‑sustaining
everswel=ever‑swelling
everunfold=ever‑unfolding
everwatch=ever‑watchful
everwiden=ever‑widening
everybod=everybody
everyday=everyday
everyon=everyone
everyth=everything
everywh=everywhere
evid=evident
evil=evil
evildo=evil‑doers
evilwish=evil‑wishers
evinc=evinced
evok=evoked
evolv=evolution
exacerb=exacerbate
exact=exact
exagg=exaggeration
exalt=exalted
exam=examine
exampl=example
exasp=exasperated
excav=excavation
exceed=exceeding
excel=excellent
except=except
excerpt=excerpt
excess=excessive
exchang=exchange
excit=excitement
exclaim=exclaim
exclud=excluded
exclus=exclusive
excommun=excommunicated
excruc=excruciating
excus=excuse
execr=execration
execut=execution
executor=executive
exeges=exegesis
exemplar=exemplary
exemplif=exemplify
exempt=exempt
exerc=exercise
exert=exert
exhaust=exhausted
exhibit=exhibited
exhilar=exhilarated
exhort=exhortations
exig=exigencies
exil=exile
exist=existence
exit=exit
exminist=ex‑ministers
exon=exonerate
exorbit=exorbitant
exp=experience
expand=expanding
expans=expansion
expat=expatiate
expect=expected
exped=expedient
expedit=expedite
expel=expelled
expend=expended
expenditur=expenditure
expens=expenses
experiment=experimentation
expert=experts
expir=expiry
explain=explained
explicit=explicit
explod=explosives
exploit=exploits
explor=explore
expon=exponents
expos=exposed
exposit=exposition
expound=expounded
express=expression
expropr=expropriation
expuls=expulsion
exquisit=exquisite
extant=extant
extend=extended
extens=extension
extent=extent
extenu=extenuating
exterior=exterior
extermin=exterminate
extern=external
extinct=extinction
extinguish=extinguished
extol=extol
extort=extort
extract=extracts
extran=extraneous
extraordinar=extraordinary
extravag=extravagant
extrem=extreme
extric=extricate
exult=exultation
eye=eyes
eyewit=eyewitness
f=flight
fabl=fables
fabric=fabric
facad=facade
face=face
facet=facets
facil=facilities
facilit=facilitate
fact=fact
faction=factions
factori=factory
facult=faculty
fade=fade
fail=failed
fain=fain
faint=faint
fair=fair
fairmind=fair‑minded
fairminded=fair‑mindedness
faith=faith
faithrel=faith
falcon=falcon
fall=fall
fallac=fallacious
fals=false
falseheart=false‑hearted
falsif=falsified
falt=falter
fam=family
fame=fame
familiar=familiar
famin=famine
famish=famished
famous=famous
fan=fan
fanat=fanaticism
fanc=fancies
fane=fane
fang=fangs
fantas=fantastic
far=far
faraway=far‑away
fare=fare
farewel=farewell
farfam=far‑famed
farflung=far‑flung
farm=farmer
faroff=far‑off
farreach=far‑reaching
farsight=far‑sighted
farstretch=far‑stretching
farth=farther
fashion=fashioned
fast=fast
fasten=fasten
fastfleet=fast‑fleeting
fat=fat
fatal=fatal
fate=fate
fateladen=fate‑laden
fath=father
fathom=fathom
fatigu=fatigue
fatten=fatten
fault=faults
favour=favour
favourit=favourite
fear=fear
feasibl=feasible
feast=feast
feat=feat
featur=features
februar=february
fecund=fecundity
feder=federal
feebl=feeble
feed=feed
feel=feel
feet=feet
felic=felicity
fellow=fellow
fellowbeliev=fellow‑believers
fellowcitizen=fellow‑citizens
fellowconspir=fellow‑conspirators
fellowcountrymen=fellow‑countrymen
fellowdiscipl=fellow‑disciples
fellowexil=fellow‑exiles
fellowlabour=fellow‑labourers
fellowman=fellowman
fellowmen=fellowmen
fellowminist=fellow‑ministers
fellowprison=fellow‑prisoners
fellowship=fellowship
fellowsovereign=fellow‑sovereigns
fellowtravel=fellow‑traveller
fellowwork=fellow‑workers
femal=female
feminin=feminine
feroc=ferocious
fertil=fertile
fervent=fervour
festiv=festival
fett=fetters
fev=fever
feverish=feverish
few=few
fibr=fibre
fiction=fiction
fidel=fidelity
field=field
fiend=fiendish
fierc=fierce
fift=fifty
fifteen=fifteen
fifteenth=fifteenth
fifth=fifth
fiftyfour=fifty‑four
fiftysix=fifty‑six
fiftytwo=fifty‑two
fig=fig
fight=fight
figur=figures
figurehead=figurehead
fil=filled
file=file
film=film
filth=filthy
fin=finis
final=finally
financ=financial
find=find
fine=fine
fing=fingers
finish=finished
finit=finite
fire=fire
firearm=firearms
firebrand=firebrands
firm=firm
firmament=firmament
firmlyknit=firmly‑knit
first=first
firstborn=firstborn
fish=fish
fist=fist
fit=fit
five=five
fivefold=five‑fold
fiveyear=five‑year
fix=fixed
flag=flag
flagrant=flagrant
flame=flame
flank=flanked
flash=flash
flaunt=flaunted
flaw=flaw
fledg=fledged
flee=flee
fleet=fleeting
flesh=flesh
flexibl=flexibility
flick=flickering
fling=flung
flock=flock
flog=flogged
flood=flood
floor=floor
flour=flour
flourish=flourish
flout=flout
flow=flow
flower=flowers
flowerbord=flower‑bordered
fluid=fluidity
flute=flute
flutt=flutter
foam=foam
focus=focus
foe=foes
foetid=foetid
foetus=foetus
foil=foiled
fol=folly
fold=fold
folk=folk
follow=followers
followup=follow‑up
fond=fondly
food=food
fool=foolish
foot=foot
footmen=footmen
footnot=footnotes
footprint=footprints
footstep=footsteps
footstool=footstool
forbear=forbearance
forbid=forbidden
forc=forces
ford=ford
fore=forests
forebear=forebears
forebod=forebodings
forecast=forecast
forefath=forefathers
forefront=forefront
forego=foregoing
forehead=forehead
foreign=foreign
forelock=forelock
foremost=foremost
foreordain=foreordained
forerunn=forerunner
forese=foresight
foreshadow=foreshadowed
foretel=foretold
forev=forever
forewarn=forewarned
foreword=foreword
forfeit=forfeit
forg=forge
forget=forget
forgiv=forgiving
forlorn=forlorn
form=form
formal=formal
formalis=formalise
format=formative
former=former
formid=formidable
formul=formulated
formula=formula
forsak=forsaken
fort=fort
forth=forth
forthcom=forthcoming
forthwith=forthwith
forti=forty
fortif=fortified
fortitud=fortitude
fortress=fortress
fortresstown=fortress‑town
fortuit=fortuitous
fortun=fortunes
fortyeight=forty‑eight
fortyf=forty‑five
fortytwo=forty‑two
fortyyear=forty‑year
forum=forum
forward=forward
fost=foster
foul=foul
foulsmel=foul‑smelling
found=found
foundat=foundation
fount=fount
fountain=fountain
fountainhead=fountainhead
four=four
fourfold=fourfold
fourteen=fourteen
fourth=fourth
fowl=fowls
fraction=fraction
fragil=fragile
fragment=fragments
fragrant=fragrance
frail=frail
frame=frame
framework=framework
frank=frank
fratern=fraternity
fraud=fraud
fraught=fraught
freedom=freedom
freez=freezing
freight=freighted
frenet=frenetic
frenz=frenzied
frequent=frequently
fresh=fresh
friday=friday
friend=friends
fright=frightened
fring=fringes
frivol=frivolous
front=front
fronti=frontiers
frost=frost
froth=froth
fruit=fruit
frustrat=frustrate
fuel=fuel
fugit=fugitive
fulcrum=fulcrum
fulfil=fulfilled
full=full
fullfledg=full‑fledged
fulltim=full‑time
fun=funeral
function=functions
functionar=functionaries
fund=fund
fundament=fundamental
fundamentalis=fundamentalism
fur=furs
furi=fury
furnish=furnished
furnitur=furnishings
furrow=furrows
further=further
furthermor=furthermore
fuse=fused
futil=futile
futur=future
gain=gain
gainsay=gainsaid
gal=galling
gale=gales
gall=gallery
gallant=gallant
gallop=galloping
gallow=gallows
galvan=galvanised
gambl=gambling
game=games
gap=gap
garb=garb
garden=garden
garlic=garlic
garment=garment
garn=garnered
garrison=garrison
gas=gas
gate=gates
gath=gathered
gaug=gauge
gay=gay
gaze=gaze
gazell=gazelles
gear=gear
gem=gems
gemlik=gem‑like
gemstud=gem‑studded
gend=gender
general=general
generalship=generals
generat=generation
generous=generous
genes=genesis
genius=genius
gentil=gentiles
gentl=gentle
gentleman=gentleman
genuin=genuine
geograph=geographic
geolog=geological
geometr=geometry
germ=germ
germin=germinate
get=get
giant=gigantic
gift=gifts
gild=gilded
gird=gird
girdl=girdle
girl=girls
girt=girt
give=given
glad=glad
gladtid=glad‑tidings
glanc=glance
glare=glaring
glass=glass
gleam=gleam
glide=glideth
glimm=glimmer
glimps=glimpse
glitt=glittering
global=global
globalis=globalisation
globe=globe
gloom=gloom
glor=glory
glow=glowing
gnash=gnashing
gnat=gnat
go=gone
goal=goal
goblet=goblet
god=god
godfear=god‑fearing
godgiven=god‑given
godintox=god‑intoxicated
gold=golden
good=good
goodby=good‑bye
goodpleasur=good‑pleasure
goodwil=goodwill
gore=gore
gospel=gospel
gossip=gossip
got=got
goug=gouged
govern=government
governor=governor
governorgen=governor‑general
grace=grace
gracious=gracious
grade=grade
gradual=gradually
graduat=graduated
graft=grafting
grain=grain
gramm=grammes
grammar=grammar
grand=grand
granddaught=grand‑daughter
grandeur=grandeur
grandfath=grandfather
grandson=grandson
granit=granite
grant=grant
graphic=graphically
grappl=grapple
grasp=grasp
grass=grass
grassroot=grassroots
grate=gratitude
gratif=gratified
grave=grave
graven=graven
gravit=gravity
graze=graze
great=great
greed=greed
green=green
greet=greetings
grief=grief
griefstricken=grief‑stricken
grievant=grievances
grievous=grievous
grim=grim
grind=grind
grip=grip
groan=groan
groom=groom
gross=gross
ground=ground
groundwork=groundwork
group=groups
grove=groves
grow=growth
gruesom=gruesome
grunt=grunting
gu=guest
guarante=guarantee
guard=guard
guardian=guardian
guid=guide
guidant=guidance
guidelin=guidelines
guil=guile
guilt=guilty
guis=guise
gulf=gulf
gun=guns
gush=gush
habit=habits
habita=habitation
habitform=habit‑forming
hack=hacked
hadst=hadst
hail=hail
hair=hair
hairsplit=hair‑splittings
half=half
halfbroth=half‑brother
halfsist=half‑sisters
hall=hall
hallmark=hallmark
hallow=hallowed
hallucinogen=hallucinogenic
halo=halo
halt=halt
halter=halters
haltingplac=halting‑place
hamlet=hamlet
hamm=hammer
hamp=hampered
hamstrung=hamstrung
hand=hands
handicap=handicapped
handiwork=handiwork
handl=handle
handmaid=handmaidens
handwrit=handwriting
hang=hanging
hangman=hanged
hap=hapless
happ=happiness
happen=happened
har=harnessed
harass=harassed
harbing=harbinger
harbour=harbour
hard=hard
hardpress=hard‑pressed
hardship=hardships
hardwon=hard‑won
harm=harm
harmon=harmony
harp=harp
harrow=harrowing
harsh=harsh
harv=harvest
hast=hast
hat=hat
hate=hatred
hatemong=hate‑mongering
haught=haughty
haul=hauled
haunt=haunts
haven=haven
havoc=havoc
hazard=hazards
haze=haze
head=head
headdress=headdress
headlong=headlong
headquart=headquarters
heal=healing
heap=heaped
hear=heard
hearken=hearken
heart=heart
heartbreak=heartbreaking
hearten=heartening
heartrend=heartrending
heartwarm=heartwarming
heat=heat
heathen=heathen
heaven=heaven
heavens=heaven‑sent
heavi=heavy
heed=heedless
height=heights
heighten=heightened
heinous=heinous
heir=heirs
hell=hell
hellfir=hellfire
help=help
helpmat=helpmates
hem=hem
hemisph=hemisphere
henc=hence
henceforth=henceforth
herald=herald
herb=herbs
herculean=herculean
herd=herd
hereaft=hereafter
hered=hereditary
herein=herein
heres=heresy
heret=heretics
heretofor=heretofore
heritag=heritage
hero=heroic
hesit=hesitate
hewn=hewn
hexagon=hexagonal
hey=hey
heyday=hey‑day
hide=hidden
hideous=hideous
hierarch=hierarchy
high=high
highlight=highlights
highlyvaunt=highly‑vaunted
highmind=high‑minded
highminded=high‑mindedness
highrank=high‑ranking
highway=highway
highwaymen=highwaymen
hill=hills
hind=hinder
hindu=hindus
hint=hints
histor=history
historic=historic
hith=hither
hitherto=hitherto
ho=holy
hoard=hoarding
hoist=hoisted
hold=held
hole=hole
holiday=holidays
holocaust=holocaust
homag=homage
home=home
homefront=homefront
homeland=homeland
homeward=homeward
homilies=homilies
homosexu=homosexuality
hone=honed
honest=honesty
honey=honey
honeysweet=honey‑sweet
honour=honour
hook=hooks
hoot=hooting
hope=hope
horizon=horizon
horr=horrors
hors=horse
horseback=horseback
horseman=horsemen
hospic=hospice
hospit=hospitality
host=hosts
hostel=hostel
hostil=hostility
hot=hot
hotel=hotel
hound=hounded
hour=hour
hous=house
household=household
housetop=housetops
hov=hovering
howev=however
howl=howling
hu=hued
hue=hue
huge=huge
hum=humiliation
human=human
humanitarian=humanitarian
humbl=humble
hundr=hundred
hundredth=hundredth
hunger=hunger
hunt=hunting
hurl=hurled
hurr=hurried
hurrican=hurricane
hurt=hurt
husband=husband
husbandman=husbandman
husk=husks
hyacinth=hyacinths
hyena=hyenas
hymn=hymns
hypocrit=hypocrisy
ice=ice
idea=ideas
ideal=ideal
ident=identity
identical=identical
identif=identified
ideolog=ideologies
idl=idle
idol=idols
ignit=ignited
ignobl=ignoble
ignomin=ignominious
ignor=ignorance
ill=ill
illeg=illegal
illfat=ill‑fated
illfeel=ill‑feeling
illfound=ill‑founded
illgotten=ill‑gotten
illhealth=ill‑health
illimit=illimitable
illit=illiterate
illog=illogical
illumin=illumined
illus=illusion
illustr=illustrate
illustri=illustrious
illwish=ill‑wishers
imag=image
imagin=imaginings
imbecil=imbecile
imbu=imbued
imit=imitations
immacul=immaculate
immatur=immature
immeasur=immeasurably
immed=immediate
immemor=immemorial
immens=immense
immers=immersed
immin=imminent
immol=immolated
immor=immorality
immort=immortal
immov=immoveable
immun=immune
immut=immutable
imp=imperial
impact=impact
impair=impair
impart=impart
imparti=impartial
impass=impassioned
imped=impede
impel=impelled
impend=impending
impenetr=impenetrable
imper=imperative
impercept=imperceptibly
imperfect=imperfect
imperil=imperilled
imperish=imperishable
imperman=impermanence
imperson=impersonal
imperv=impervious
impetu=impetuous
impetus=impetus
imping=impinge
impious=impiety
impl=implies
implac=implacable
implant=implanted
implement=implementation
implic=implications
implicit=implicit
implor=implore
import=important
importun=importunity
impos=imposed
imposit=imposition
imposs=impossible
impostor=impostor
impot=impotent
impoverish=impoverished
impregn=impregnable
impress=impressive
impression=impression
imprint=imprinted
imprison=imprisonment
improv=improve
imprud=imprudence
impuls=impulse
imput=imputed
inabl=inability
inaccess=inaccessible
inaccur=inaccurate
inadequ=inadequate
inadmiss=inadmissible
inadvert=inadvertently
inanim=inanimate
inappropr=inappropriate
inasmuch=inasmuch
inaugur=inaugurated
incalcul=incalculable
incandesc=incandescent
incap=incapable
incarc=incarceration
incarn=incarnation
incens=incensed
incept=inception
incess=incessant
incid=incidents
incip=incipient
incit=incited
inclin=incline
includ=including
inclus=inclusion
incoh=incoherent
incom=incoming
income=income
incompar=incomparable
incompat=incompatible
incompet=incompetence
incomplet=incomplete
incomprehens=incomprehensible
inconceiv=inconceivable
inconclus=inconclusive
inconsid=inconsiderable
inconsist=inconsistent
inconst=inconstant
incontest=incontestable
incontrovert=incontrovertible
inconven=inconvenience
incorpor=incorporated
incorrupt=incorruptible
increas=increase
incred=incredible
incub=incubation
inculc=inculcated
incumb=incumbent
incur=incurred
incurable=incurable
inde=indeed
indec=indecencies
indefatig=indefatigable
indefinit=indefinitely
indel=indelible
indentur=indenture
independ=independent
indescrib=indescribable
indestruct=indestructible
index=index
indic=indicated
indiff=indifference
indig=indigent
indigen=indigenous
indign=indignities
indirect=indirectly
indiscrimin=indiscriminate
indispens=indispensable
indisput=indisputable
indissolubl=indissoluble
indistinguish=indistinguishable
individu=individual
individualis=individualism
individualit=individuality
individuat=individuations
indivis=indivisible
indol=indolence
indomit=indomitable
indubit=indubitably
induc=induced
indulg=indulge
industr=industry
inebr=inebriated
ineff=ineffable
ineffect=ineffective
inequ=inequality
inequit=inequity
inert=inert
inescap=inescapable
inestim=inestimable
inevit=inevitable
inexhaust=inexhaustible
inexor=inexorably
inexp=inexperienced
inextinguish=inextinguishable
inextric=inextricably
inf=infer
infal=infallibility
infam=infamous
infant=infant
inferior=inferior
infern=infernal
infest=infested
infidel=infidels
infin=infinite
infinitesim=infinitesimal
infirm=infirmities
inflam=inflamed
inflex=inflexible
inflict=inflicted
influent=influence
influx=influx
inform=informed
infract=infraction
infrequ=infrequently
infring=infringe
infur=infuriated
infus=infused
ingen=ingenuity
ingrain=ingrained
ingred=ingredients
ingress=ingress
inh=inherent
inhabit=inhabitants
inhal=inhale
inherit=inheritance
inhibit=inhibit
inhospit=inhospitable
inhuman=inhuman
inim=inimical
iniqu=iniquity
init=initial
injur=injury
injustic=injustice
inmat=inmates
inmost=inmost
innat=innate
inner=inner
innoc=innocent
innov=innovative
innum=innumerable
inordin=inordinate
inquir=inquiry
insat=insatiable
inscrib=inscribed
inscrut=inscrutable
insecur=insecure
insens=insensibly
insepar=inseparable
insert=inserted
insid=inside
insidi=insidious
insight=insight
insignific=insignificant
insinu=insinuations
insist=insistent
insol=insolently
inspect=inspection
inspir=inspired
instabl=instability
instal=installation
instant=instance
instantan=instantaneous
instead=instead
instig=instigated
instil=instil
instinct=instincts
institut=institutions
institute=institute
instruct=instructions
instrument=instruments
insuffic=insufficient
insular=insular
insult=insults
insup=insuperable
int=inter
intact=intact
integr=integration
integral=integral
integrity=integrity
intellect=intellectual
intellig=intelligence
intemp=intemperate
intend=intended
intens=intensive
intent=intention
interact=interactions
interamerica=inter‑america
intercalar=intercalary
interced=intercede
intercept=interception
intercess=intercession
interchang=interchange
intercommun=intercommunication
interconnect=interconnected
intercontinent=intercontinental
intercours=intercourse
interdepend=interdependence
interdict=interdiction
interest=interests
interf=interference
interfaith=interfaith
interior=interior
intermed=intermediary
intermin=interminable
intermitt=intermittent
intern=internal
international=international
internet=internet
interpol=interpolated
interpos=interposed
interpret=interpretation
interrac=inter‑racial
interrel=interrelated
interrog=interrogation
interrupt=interruption
interspers=interspersed
intertwin=intertwined
interv=interval
interven=intervened
intervent=intervention
interview=interview
interweav=interwoven
intest=intestacy
intim=intimate
intimation=intimation
intimid=intimidation
intol=intolerance
inton=intone
intox=intoxicated
intract=intractable
intrepid=intrepid
intric=intricate
intrigu=intrigues
intrins=intrinsic
introduc=introduced
intuit=intuitive
inv=invest
invad=invading
invalid=invalidate
invalu=invaluable
invar=invariably
invect=invectives
invent=inventions
invest=invested
investig=investigation
invigor=invigorated
invinc=invincible
inviol=inviolable
invis=invisible
invit=invited
invok=invoke
involuntar=involuntary
involv=involved
inward=inwardly
irasc=irascibility
irat=irate
iron=iron
irrat=irrational
irreconcil=irreconcilable
irrefut=irrefutable
irregular=irregularity
irrelig=irreligion
irrepar=irreparable
irrepress=irrepressible
irresist=irresistible
irrespect=irrespective
irrespons=irresponsible
irretriev=irretrievably
irrev=irreverent
irrevoc=irrevocable
isl=isles
islam=islam
island=islands
isol=isolated
issu=issues
item=items
itin=itinerant
ivb=ivb
ivor=ivory
jail=jail
januar=january
jasmin=jasmine
jealous=jealousy
jeopard=jeopardise
jesus=jesus
jew=jews
jewel=jewel
job=job
join=join
joke=joking
jot=jot
journal=journal
journey=journey
joy=joy
ju=july
jubile=jubilee
judg=judgement
judgemental=judgemental
judic=judicious
judiciar=judicial
junctur=juncture
june=june
jungl=jungle
junior=junior
jurisdict=jurisdiction
jus=just
just=justice
justif=justify
keen=keen
keep=keep
ken=ken
key=key
keynot=keynote
kid=kid
kidnap=kidnapped
kill=killed
kin=kindreds
kind=kindness
kindl=kindled
kinds=kind
king=king
kingdom=kingdom
kiss=kissed
knead=kneaded
knee=knees
kneel=kneeling
knell=knell
knife=knives
knight=knights
knit=knit
know=know
knowledg=knowledge
l=lilies
label=label
laborator=laboratory
labour=labour
lac=lacerated
lack=lack
lad=lad
ladd=ladder
laden=laden
ladi=lady
lake=lake
lamb=lamb
lament=lament
lamp=lamp
lanc=lance
land=land
landed=landing
landingstag=landing‑stage
landmark=landmark
landscap=landscape
languag=language
languish=languished
lap=lap
laps=lapse
larg=large
largescal=large‑scale
largess=largesse
lash=lashes
last=last
late=later
latent=latent
latin=latin
latitud=latitude
latt=latter
laud=lauded
laugh=laugh
laughingstock=laughingstock
launch=launched
laurel=laurels
law=law
lawabid=law‑abiding
lawgiv=lawgiver
lawy=lawyer
lax=laxity
lay=laid
layman=layman
lead=leaders
leaf=leaf
leaflet=leaflets
leagu=league
leap=leap
learn=learning
leas=lease
least=least
leath=leather
leav=leave
leaven=leaven
lectur=lectures
leeway=leeway
left=left
leg=legs
legal=legal
legat=legacy
legate=legation
legion=legions
legisl=legislation
legitim=legitimate
leisur=leisure
lend=lend
length=length
lenient=leniency
lent=lent
leopard=leopard
lep=leper
less=less
lesson=lessons
lest=lest
let=let
letharg=lethargy
lett=letter
level=level
levi=levied
leviathan=leviathan
liabil=liability
liabl=liable
liais=liaison
liar=liar
lib=liberal
liberat=liberation
libert=liberty
libra=libra
librar=library
licent=licence
lie=lie
lieuten=lieutenant
life=life
lifeblood=life‑blood
lifegiv=life‑giving
lifelong=life‑long
lifetim=lifetime
lifevein=life‑vein
lifework=lifework
lift=lifted
light=light
lighten=lighten
lightn=lightning
like=like
likemind=like‑minded
liken=likened
likew=likewise
limb=limbs
limit=limited
line=lines
lineag=lineage
linen=linen
ling=linger
link=linked
lion=lion
lionheart=lion‑hearted
lip=lips
liquid=liquid
liquor=liquor
list=list
listen=listen
lit=lit
liter=literally
literar=literature
litig=litigation
littl=little
liv=livery
live=lives
livelihood=livelihood
liver=liver
livestock=livestock
load=load
loath=loathsome
loav=loaves
lobe=lobe
local=local
locat=located
lock=locks
lodg=lodged
loft=lofty
logic=logical
loin=loins
lone=loneliness
long=longing
longawait=long‑awaited
longcherish=long‑cherished
longdef=long‑deferred
longdrawn=long‑drawn
longdrawnout=long‑drawn‑out
longer=long
longitud=longitude
longpersecut=long‑persecuted
longstand=long‑standing
longsuff=long‑suffering
longterm=long‑term
look=look
loom=loom
loos=loose
loot=looting
lord=lord
lose=lost
lot=lot
lote=lote
lotetre=lote‑tree
lott=lotteries
lotus=lotus
loud=loudly
love=love
lovecr=love‑creating
lovingkind=loving‑kindness
low=low
lowborn=lowbred
lowli=lowliness
lowroof=low‑roofed
loyal=loyalty
lsd=lsd
lucid=lucid
ludicr=ludicrous
lull=lull
lumin=luminous
luminar=luminary
lump=lump
lunar=lunar
lunat=lunatic
lunch=lunch
lurk=lurk
lush=lush
lust=lust
lustr=lustre
lute=lute
luxur=luxury
lyre=lyre
machin=machinery
mad=madness
maelstrom=maelstrom
magazin=magazine
magic=magic
magistr=magistrates
magnanim=magnanimity
magnet=magnet
magnif=magnified
magnific=magnificent
magnitud=magnitude
maid=maidservant
maiden=maiden
mail=mail
main=main
mainland=mainland
mainspr=mainspring
mainstay=mainstay
maintain=maintain
mainten=maintenance
majest=majesty
majesty=majesty
major=major
majorit=majority
make=made
malad=maladies
malais=malaise
malaria=malaria
male=male
maledict=malediction
malevol=malevolent
malic=malice
malign=malignant
mallet=mallet
man=man
manag=management
mandat=mandate
mandator=mandatory
mangl=mangled
mani=many
manif=manifest
manifold=manifold
mankind=mankind
manmad=man‑made
mann=manner
mansion=mansion
manslaught=manslaughter
manslay=man‑slayers
mantl=mantle
manuscript=manuscript
manyhu=many‑hued
map=map
mar=marred
marbl=marble
march=march
margin=margin
mark=marked
market=market
marr=marriage
marshal=marshalled
martyr=martyrdom
martyrherald=martyr‑herald
martyrprophet=martyr‑prophet
marvel=marvellous
masculin=masculine
mass=masses
massacr=massacre
massiv=massive
master=master
mat=mat
match=matchless
mate=mates
mater=material
materialist=materialism
matern=maternal
mathemat=mathematics
matrix=matrix
matter=matter
matur=maturity
mausoleum=mausoleum
maw=maw
may=mayest
mayor=mayor
meadow=meadows
meal=meal
mean=means
meantim=meantime
meanwhil=meanwhile
measur=measure
meat=meat
mechan=mechanisms
meddl=meddle
media=media
mediaev=mediaeval
mediat=mediator
medic=medical
medicin=medicine
medit=meditate
medium=medium
meek=meekness
meet=meet
melancho=melancholy
melod=melodies
melt=melted
memb=members
membership=membership
memoir=memoirs
memor=memory
memorabl=memorable
memorandum=memorandum
memorial=memorial
memoris=memorise
menac=menace
mendic=mendicancy
ment=ment
mental=mental
mention=mention
merc=mercy
merchand=merchandise
merchant=merchant
mercyseat=mercy‑seat
mere=mere
merg=merged
meridian=meridian
merit=meritorious
merr=merry
mesh=mesh
messag=message
messiah=messiah
metal=metal
metaphor=metaphor
meteor=meteor
methink=methinks
method=methods
meticul=meticulous
metr=metres
metropo=metropolis
microscop=microscopic
mid=mid
midday=midday
middl=middle
midmost=midmost
midnight=midnight
midpoint=midpoint
midst=midst
midsumm=mid‑summer
midway=midway
migh=might
might=mighty
mild=mild
mile=miles
mileston=milestone
milit=military
milk=milk
mill=mills
millenn=millennium
millennialong=millennia‑long
million=million
millionair=millionaires
minaret=minarets
mind=mind
mindset=mindset
mine=mine
mineral=mineral
mingl=mingled
minim=minimum
minist=ministry
minor=minority
minuscul=minuscule
minut=minutes
miracl=miracles
mirag=mirage
mire=mire
mirror=mirror
mis=misery
misapprehend=misapprehended
misbehaviour=misbehaviour
misbelief=misbelief
miscarriag=miscarriage
mischief=mischief
mischiefmak=mischief‑makers
misconc=misconceptions
misconduct=misconduct
misconstru=misconstrued
misde=misdeeds
misdirect=misdirected
misfortun=misfortunes
misgiv=misgivings
misguid=misguided
misinform=misinformed
misinterpret=misinterpreted
mislead=misleading
mismanag=mismanagement
misrepres=misrepresentation
misrul=misrule
miss=miss
mission=mission
missionar=missionaries
mist=mists
mistak=mistake
mistreat=mistreatment
misunderstand=misunderstandings
misus=misuse
mitig=mitigated
moan=moan
moat=moat
mob=mob
mobil=mobilise
mock=mock
mod=moderation
mode=mode
model=model
modern=modern
modest=modesty
modif=modify
modul=modules
moist=moisture
molest=molest
moment=moment
momentar=momentarily
momentum=momentum
monarch=monarch
monast=monks
money=money
mong=mongers
monitor=monitoring
monkey=monkeys
monogam=monogamy
monolith=monolith
monoton=monotonous
monst=monster
monstrous=monstrous
month=months
monument=monument
monumental=monumental
mood=moody
moon=moon
moonlight=moonlit
moral=moral
more=more
moreov=moreover
moribund=moribund
morn=morning
morrow=morrow
mortal=mortal
mortif=mortification
mosaic=mosaic
mose=moses
mosqu=mosque
most=mostly
mote=mote
moth=moth
mother=mother
mothlik=moth‑like
motion=motion
motiv=motive
mould=mouldering
mount=mount
mountain=mountain
mourn=mourning
mous=mouse
mouth=mouth
mouthpiec=mouthpiece
move=movement
mow=mow
mrs=mrs
much=much
muchfear=much‑feared
muchlov=much‑loved
muchneed=much‑needed
muchpriz=much‑prized
mud=mud
mule=muleteers
multin=multinational
multip=multiplication
multitud=multitude
munific=munificence
murd=murder
murmur=murmur
museum=museum
music=music
musk=musk
musket=muskets
muskladen=musk‑laden
muskscent=musk‑scented
muslim=muslim
mustard=mustard
muster=muster
mutat=mutatis
mute=mute
mutil=mutilated
mutin=mutiny
mutual=mutual
myriad=myriad
myst=mysteries
mystic=mystic
nail=nails
nake=naked
name=name
nape=nape
narrat=narrative
narrow=narrow
narrowmind=narrow‑minded
nascent=nascent
nation=national
nationalis=nationalism
nationst=nation‑states
nativ=native
natur=nature
natural=natural
naught=naught
nav=naval
navig=navigate
nay=nay
near=near
neath=neath
necess=necessary
neck=neck
nectar=nectar
need=need
nefar=nefarious
negative=negative
neglect=neglected
negligible=negligible
negot=negotiations
negro=negro
neighbour=neighbours
neighbourhood=neighbourhood
neith=neither
neophyt=neophytes
nephew=nephew
nerv=nerve
nervecentr=nerve‑centre
nervous=nerves
nest=nest
nestl=nestle
net=net
neth=nether
network=network
nev=never
neverend=never‑ending
neverth=nevertheless
new=new
newborn=newborn
newlyacclaim=newly‑acclaimed
news=news
newslett=newsletter
newspap=newspapers
next=next
ngo=ngo
nich=niche
niec=nieces
nigh=nigh
night=night
nightingal=nightingale
nightseason=night‑season
nihil=nihilism
nine=nine
ninet=ninety
nineteen=nineteen
nineteenth=nineteenth
nineteenthcentur=nineteenth‑century
ninetyf=ninety‑five
ninetyon=ninety‑one
nineyear=nine‑year
ninth=ninth
nobl=noble
nois=noised
nomad=nomadic
nomin=nominee
nominal=nominal
non=non
nonbeliev=non‑believers
noncash=non‑cash
nonchristian=non‑christian
none=none
nonessent=nonessential
noneth=nonetheless
nonexist=nonexistence
nonfulfil=nonfulfilment
nongovernment=non‑governmental
noninvolv=non‑involvement
nonparticip=non‑participation
nonpartisan=non‑partisan
nonpolit=non‑political
nonsectarian=non‑sectarian
nook=nook
noon=noon
noos=noose
nor=nor
norm=norms
normal=normal
north=north
northeast=northeastern
northw=northwestern
nose=noses
nostril=nostrils
notabl=notable
note=noted
noth=nothing
notic=notice
notif=notified
notion=notion
notor=notorious
notwithstand=notwithstanding
nourish=nourished
novemb=november
now=now
nowh=nowhere
nuanc=nuanced
nuclear=nuclear
nucleus=nucleus
nudism=nudism
nullif=nullify
num=numerous
numb=numbed
number=number
nurs=nursed
nurtur=nurtured
oath=oath
obed=obedience
obey=obey
object=object
objection=objection
oblig=obligation
oblit=obliterated
obliv=oblivious
oblivion=oblivion
obscur=obscure
observ=observe
obsess=obsessed
obsolet=obsolete
obstacl=obstacles
obstin=obstinately
obstruct=obstruct
obtain=obtain
obvious=obvious
occas=occasion
occasion=occasionally
occid=occident
occult=occultation
occup=occupied
occur=occur
ocean=ocean
oceania=oceanic
octagon=octagon
octob=october
odd=odds
ode=odes
odious=odious
odour=odour
off=offer
offend=offence
offic=office
offshoot=offshoot
offshor=offshore
offspr=offspring
often=often
oftentim=oftentimes
oil=oil
old=old
oligarch=oligarchy
oliv=olive
omega=omega
omin=ominous
omit=omitted
omnipot=omnipotent
omnipres=omnipresent
omnisc=omniscient
onc=once
one=ones
onefifth=one‑fifth
onehalf=one‑half
oneself=oneself
onethird=one‑third
ongo=ongoing
onli=only
onlook=onlookers
onrush=onrushing
onset=onset
onslaught=onslaught
onto=onto
onward=onward
op=operation
open=open
openminded=open‑mindedness
opiat=opiate
opinion=opinion
opinionated=opinionated
opium=opium
oppon=opponents
opportun=opportunity
oppos=opposition
opposit=opposite
oppress=oppression
optimist=optimism
option=options
oral=orally
orat=orator
orb=orb
orbit=orbit
orchard=orchard
ord=order
ordain=ordained
ordeal=ordeals
order=order
orders=order
ordin=ordinances
ordinar=ordinary
org=orgy
orga=organs
organ=organic
organis=organised
organisation=organisation
organism=organism
orient=orientation
oriental=orient
origin=original
ornament=ornament
orphan=orphans
orthodox=orthodoxy
ostent=ostentation
ostrac=ostracism
oth=other
otherw=otherwise
ought=ought
ounc=ounce
ourself=ourself
out=outlying
outbreak=outbreak
outburst=outburst
outcom=outcome
outcr=outcry
outer=outer
outflow=outflow
outgo=outgoing
outlaw=outlawing
outlay=outlay
outlet=outlet
outlin=outlined
outlook=outlook
outpost=outposts
outpour=outpourings
output=output
outrag=outrages
outreach=outreach
outset=outset
outshin=outshine
outsid=outside
outskirt=outskirts
outspread=outspread
outstand=outstanding
outstretch=outstretched
outstrip=outstrip
outward=outward
outwardlook=outward‑looking
outweigh=outweigh
outworn=outworn
ov=over
overal=overall
overbear=overbearing
overcom=overcome
overestim=overestimated
overexagg=over‑exaggerate
overflow=overflowing
overhear=overhear
overjoy=overjoyed
overlap=overlap
overlook=overlook
overpow=overpowering
overr=overrate
overrid=overriding
overse=overseeing
oversea=overseas
overspread=overspread
overst=overstated
overstep=overstep
overstress=overstress
overt=overt
overtak=overtaken
overthrow=overthrow
overwhelm=overwhelming
owe=owing
owl=owl
own=ownership
p=piers
pace=pace
pack=pack
pact=pact
pagan=pagan
page=pages
pageant=pageantry
pain=pain
painstak=painstakingly
paint=painting
pair=pairs
palac=palace
pale=pale
palm=palm
palpabl=palpable
paltr=paltry
pamp=pampered
pamphlet=pamphlets
pandem=pandemic
panel=panels
pang=pangs
panic=panic
panicstricken=panic‑stricken
panop=panoply
pant=pant
pap=paper
papal=pope
parabl=parable
parad=paradise
paradigm=paradigm
paradox=paradoxical
paragraph=paragraph
parallel=parallel
paralys=paralysed
paramount=paramount
parapet=parapet
parch=parched
pardon=pardon
pare=pare
parent=parents
park=parks
parliament=parliament
parrot=parrots
part=part
partak=partake
parti=party
partial=partial
particip=participation
particular=particular
partisan=partisan
partn=partners
pass=pass
passag=passage
passion=passion
passiv=passive
passport=passports
past=past
pastim=pastime
pastor=pastor
pastur=pasture
patent=patent
patern=paternal
paternalis=paternalism
path=path
pathet=pathetic
pathway=pathway
patient=patience
patriarch=patriarchs
patrimon=patrimony
patriot=patriotic
pattern=pattern
paup=paupers
paus=pause
pave=pave
pavilion=pavilion
pawn=pawns
pay=pay
pe=peerless
peac=peace
peacebring=peace‑bringing
peacelov=peace‑loving
peal=peal
pearl=pearls
peasant=peasants
pebbl=pebbles
peculiar=peculiar
pecuniar=pecuniary
pedagog=pedagogical
peddl=peddler
pelt=pelted
pen=pen
penal=penalty
pencas=pen‑case
pend=pending
penetr=penetrating
peninsula=peninsula
penit=penitence
penitentiar=penitentiaries
penn=penny
pennyworth=pennyworth
pension=pension
pent=pent
pentateuch=pentateuch
pentup=pent‑up
peopl=people
per=per
perceiv=perceive
percent=percentage
percept=perception
perchant=perchance
perdit=perdition
peremptor=peremptorily
perenn=perennial
perfect=perfect
perfid=perfidious
perforc=perforce
perform=perform
perfum=perfume
perhap=perhaps
peril=peril
period=period
perish=perish
perk=perks
perman=permanent
permeat=permeate
permiss=permissible
permit=permitted
permut=permutations
pernic=pernicious
perpetr=perpetrated
perpetu=perpetual
perplex=perplexed
persecut=persecution
persev=persevere
persia=persia
persist=persistent
person=person
personag=personage
personif=personified
perspect=perspective
perspicu=perspicuous
persuas=persuaded
pertain=pertaining
perturb=perturbed
perus=perused
pervad=pervasive
pervers=perversity
pervert=perverted
pestil=pestilential
petal=petals
petit=petition
petrif=petrifieth
pett=petty
pettyminded=petty‑mindedness
pharaoh=pharaoh
pharise=pharisees
phase=phase
phenomen=phenomenal
phenomena=phenomena
philanthrop=philanthropic
philosoph=philosophers
phoenix=phoenix
phonograph=phonograph
photo=photograph
phrase=phrase
physic=physicist
physical=physical
physician=physician
pictur=picture
piec=pieces
pierc=pierced
piet=piety
pilgrim=pilgrims
pillag=pillaged
pillar=pillars
pillow=pillow
pilot=pilot
pine=pine
pione=pioneers
pistol=pistol
pit=pit
pitch=pitched
pitchblack=pitch‑black
pitfal=pitfalls
pith=pith
piti=pity
pivot=pivot
place=place
plagu=plague
plain=plain
plaintiff=plaintiff
plaintiv=plaintive
plan=plan
plane=plane
planet=planet
plant=plant
plantat=plantations
plast=plaster
plateau=plateau
platform=platform
play=play
playground=playgrounds
plea=plea
pleas=pleaseth
pleasur=pleasure
pledg=pledge
plenar=plenary
plent=plenitude
plight=plight
plot=plot
plough=plough
plumag=plumage
plund=plundered
plung=plunged
plural=plurality
plus=plus
poet=poets
poignant=poignant
point=point
pois=poised
poison=poison
pol=polling
polar=polarisation
pole=pole
polic=police
polici=policy
polish=polished
polit=political
politic=politic
pollut=pollution
polygam=polygamy
pomp=pomp
ponder=ponder
pontif=pontificate
pontiff=pontiff
pool=pool
poor=poor
popul=population
popular=popular
port=port
portal=portals
portend=portentous
portion=portion
portrait=portrait
portray=portray
pose=posed
position=position
positive=positive
possess=possess
possibilit=possibilities
possibl=possible
post=post
postal=postal
posterity=posterity
posthum=posthumously
postliterat=post‑literacy
postpon=postponed
postul=postulates
postur=posture
postwar=post‑war
pot=pottery
potent=potent
potentate=potentates
potenti=potentialities
pound=pounds
pour=poured
povert=poverty
pow=power
pr=priests
practic=practical
practis=practice
prair=prairies
prais=praise
praiseworth=praiseworthy
pray=prayer
prayeransw=prayer‑answering
prayerhear=prayer‑hearing
preach=preaching
precar=precarious
precaut=precautions
preced=preceded
precept=precepts
precinct=precincts
precious=precious
precipit=precipitated
precis=precisely
preconceiv=preconceived
precursor=precursor
predeceas=predecessors
predict=predicted
predispos=predisposed
predomin=predominant
preemin=preeminent
preexist=preexistent
pref=preferable
pregnant=pregnant
prejud=prejudice
prelat=prelates
preliminar=preliminary
prelud=prelude
prem=premier
prematur=premature
premis=premises
premonit=premonitory
preoccup=preoccupied
preordain=preordained
prepar=prepared
prepond=preponderating
prerequisit=prerequisites
prerog=prerogatives
presag=presaging
prescrib=prescribed
present=present
presentation=presentation
presentday=present‑day
preserv=preserved
presid=presided
presiden=president
press=pressing
pressur=pressure
prestig=prestige
presum=presumptuous
presuppos=presupposes
pretend=pretend
pretens=pretensions
pretext=pretext
prevail=prevailing
prevent=prevent
previous=previous
prey=prey
price=priceless
pride=pride
priest=priesthood
primal=primal
primar=primary
primat=primacy
prime=prime
primit=primitive
primogenitur=primogeniture
princ=prince
princip=principal
principalit=principalities
principl=principles
print=printed
prior=prior
priorit=priority
prison=prison
prisonc=prison‑city
prisoncel=prison‑cell
prisonfortress=prison‑fortress
pristin=pristine
priv=privily
privat=private
privation=privations
privileg=privilege
prize=prizes
pro=pro
probabl=probably
probit=probity
problem=problems
procedur=procedures
proceed=proceed
process=process
proclaim=proclaim
procliv=proclivities
procreat=procreation
prod=prod
prodig=prodigious
produc=produce
product=product
production=production
prof=prof
profan=profane
profess=profess
profession=professional
professor=professor
proff=proffered
profic=proficient
profit=profit
proflig=profligate
profound=profound
profus=profusion
progen=progeny
programm=programme
progress=progress
prohibit=prohibition
project=projects
projection=projected
proletariat=proletariat
prolif=prolific
prolix=prolixity
prolong=prolonged
promin=prominent
promis=promised
promiscu=promiscuity
promot=promote
prompt=prompted
promulg=promulgated
prong=pronged
pronounc=pronounced
proof=proof
propag=propagation
propaganda=propaganda
propel=propelled
propens=propensities
proper=proper
propert=property
prophet=prophets
propit=propitious
propon=proponents
proport=proportion
propos=proposed
proposit=proposition
propound=propounded
propriet=propriety
proscrib=proscribed
prose=prose
prosecut=prosecution
proselyt=proselytising
prosp=prosperity
prospect=prospects
prostitut=prostitution
prostrat=prostrate
protagonist=protagonists
prote=protest
protect=protection
protectorate=protectorates
protest=protested
protestant=protestant
protocol=protocol
protrud=protrude
proud=proud
provid=provide
provident=providentially
provinc=province
provis=provisions
provision=provisional
provok=provoked
prowess=prowess
proxim=proximity
prudent=prudence
prune=pruning
psalm=psalms
psychiatr=psychiatrist
psychic=psychical
psycholog=psychological
public=public
publication=publication
publicis=publicity
publish=published
pul=pull
pulp=pulp
pulpit=pulpits
pulpittop=pulpit‑top
puls=pulse
pun=puny
punish=punishment
pupil=pupil
purchas=purchase
pure=pure
purg=purge
purif=purify
purport=purport
purpos=purpose
pursu=pursued
purview=purview
push=pushed
put=put
putrid=putrified
pyramid=pyramid
qu=quest
qua=qua
quadrant=quadrant
quadrupl=quadrupled
quaf=quaffed
quail=quail
quak=quake
qualif=qualified
qualit=qualities
quarrel=quarrels
quart=quarter
queen=queen
quench=quench
question=question
quick=quickened
quiescent=quiescent
quiet=quiet
quintess=quintessence
quit=quit
quite=quite
quixot=quixotic
quot=quoted
race=race
racism=racism
radiant=radiance
radic=radical
radio=radio
rage=raging
railroad=railroads
raiment=raiment
rain=rain
rais=raised
ral=rally
ramif=ramifications
rampant=rampant
ramshackl=ramshackle
ran=ran
ranch=ranch
rancour=rancour
random=random
rang=range
rank=rank
ransom=ransom
rapac=rapacious
rape=rape
rapid=rapidly
rapt=rapture
rash=rash
rate=rate
rath=rather
ratif=ratified
ratio=ratio
ration=rational
ravag=ravaged
rave=ravings
raven=raven
ravenous=ravening
ravish=ravishing
raw=raw
ray=rays
raze=razed
razor=razor
re=rely
reach=reach
react=reaction
reactionar=reactionary
read=read
readi=ready
readjust=readjustment
reaffirm=reaffirm
real=real
realis=realise
realist=realistic
realit=reality
reall=really
realm=realm
reanim=reanimated
reap=reap
reappear=reappear
rear=reared
rearisen=rearisen
reason=reason
reassess=reassessment
reassur=reassurance
reawaken=reawakening
rebel=rebellion
rebirth=rebirth
rebuild=rebuilding
rebuk=rebuke
recal=recall
recalcitr=recalcitrant
recant=recant
recast=recast
reced=receding
receipt=receipt
receiv=received
recent=recent
recept=reception
receptiv=receptive
recip=recipes
recipi=recipients
reciproc=reciprocity
recit=recite
reck=reckless
reckon=reckoned
reclus=recluses
recogn=recognise
recoil=recoil
recollect=recollection
recommend=recommendations
recompens=recompense
reconc=reconciliation
reconcil=reconciled
reconstitut=reconstituted
reconstruct=reconstruction
record=recorded
recount=recount
recours=recourse
recov=recover
recreat=recreation
recrimin=recriminations
recrudesc=recrudescence
recruit=recruits
rectitud=rectitude
recur=recurring
red=red
redeem=redeeming
redempt=redemption
redhot=red‑hot
redol=redolent
redoubl=redouble
redoubt=redoubtable
redound=redound
redress=redress
reduc=reduced
reelect=reelected
reemerg=reemerged
reestablish=reestablished
reexamin=reexamination
ref=referred
refin=refinement
reflect=reflect
refocus=refocus
reform=reform
refrain=refrain
refresh=refreshed
refug=refuge
refuge=refugees
refulg=refulgent
refus=refused
refut=refute
regal=regal
regard=regard
regen=regeneration
regim=regime
regiment=regiment
region=regional
regist=registered
registr=registration
registrar=registrar
registri=registry
regress=regress
regret=regret
regul=regulations
regular=regular
rehabilit=rehabilitate
reign=reign
rein=reins
reincarn=reincarnation
reinforc=reinforce
reinstat=reinstatement
reinvigor=reinvigorate
reit=reiterated
reject=rejected
rejoic=rejoice
rejoin=rejoined
rejuven=rejuvenated
relat=related
relationship=relationship
relative=relatively
relatives=relatives
relax=relax
releas=released
releg=relegated
relent=relentless
relev=relevant
reliabl=reliable
reliant=reliance
relic=relics
reliev=relief
relig=religion
relinquish=relinquish
relish=relish
reluct=reluctant
remain=remain
remark=remarkable
remed=remedy
rememb=remembrance
remind=reminder
reminisc=reminiscent
remnant=remnant
remonstr=remonstrances
remors=remorse
remot=remoteness
remov=removed
remun=remuneration
rend=rend
render=render
renew=renewed
renounc=renounce
renov=renovation
renown=renowned
rent=rent
renunc=renunciation
reopen=reopened
reord=reordering
reorgan=reorganisation
reorient=reorientation
rep=reply
repair=repaired
repar=reparations
repeat=repeatedly
repel=repel
repent=repent
repercuss=repercussions
repetit=repetition
replac=replaced
replenish=replenishment
replet=replete
report=reports
repos=repose
repositor=repository
reprehens=reprehensible
repres=representatives
repress=repression
reprimand=reprimands
reproach=reproach
reproduc=reproduced
reprov=reproved
republ=republic
repud=repudiated
repugn=repugnant
reput=reputed
reputa=reputation
requ=request
requir=required
requisit=requisite
requit=requite
res=resilience
rescu=rescue
research=research
resembl=resemble
resent=resentment
reserv=reserved
reservation=reservation
reservoir=reservoir
resettl=resettlement
reshap=reshaped
resid=residence
resign=resignation
resist=resist
resolut=resolution
resolv=resolve
reson=resonates
resort=resort
resound=resounding
resourc=resources
respect=respect
respit=respite
resplend=resplendent
respond=response
responsib=responsibility
responsiv=responsive
rest=rest
restingplac=resting‑place
restitut=restitution
restiv=restive
restlie=rest
restor=restored
restrain=restraint
restrict=restrictions
restructur=restructuring
restt=rest
result=result
resum=resume
resurg=resurgence
resurrect=resurrection
resuscit=resuscitated
reta=retaliation
retain=retain
retard=retard
retinu=retinue
retir=retirement
retold=retold
retort=retorted
retrac=retrace
retract=retract
retreat=retreats
retribut=retribution
return=return
reunion=reunion
rev=reverence
reveal=revealed
revel=revellers
revelat=revelation
reveng=revenge
revenu=revenue
reverb=reverberate
reverend=reverend
revers=reversed
revert=revert
review=review
revil=reviled
revis=revised
revit=revitalisation
reviv=revived
revivif=revivified
revoic=revoiced
revolt=revolt
revolution=revolution
revolv=revolve
reward=reward
rhyme=rhyme
rhythm=rhythm
rib=ribs
ribbon=ribbons
rich=rich
rid=rid
riddl=riddled
ride=riding
ridg=ridge
ridicul=ridicule
rife=rife
rifl=rifle
right=right
righteous=righteousness
rights=rights
rigid=rigid
rigour=rigorous
ring=ring
riot=riots
rip=ripped
ripe=ripe
rise=rise
risk=risk
rite=rites
ritual=rituals
riv=river
rival=rival
riverbank=riverbanks
road=road
roadsid=roadside
roam=roam
roar=roar
rob=robbed
robe=robe
rock=rock
rod=rod
rol=rolled
role=role
roof=roof
room=room
root=root
rope=rope
rose=rose
rosegarden=rose‑garden
round=round
rous=roused
rout=routing
routin=routine
rove=rove
row=row
royal=royal
rub=rubbeth
rubi=ruby
rude=rudely
rudiment=rudimentary
ruffian=ruffians
ruin=ruin
rule=rulers
rumbl=rumblings
rumour=rumours
run=run
rural=rural
ruse=ruse
rush=rush
rustl=rustling
ruthless=ruthless
s=series
sacerdot=sacerdotal
sack=sacked
sacr=sacred
sacrament=sacrament
sacrif=sacrifice
sad=sad
saddl=saddles
safe=safe
safeguard=safeguard
safekeep=safekeeping
sagac=sagacity
sage=sages
sail=sailing
saint=saints
sake=sake
salient=salient
salon=salon
salt=salt
salubr=salubrious
salut=salutations
salutar=salutary
salv=salve
salvat=salvation
same=same
samovar=samovar
sanctif=sanctified
sanction=sanction
sanctuar=sanctuary
sand=sands
sandal=sandals
sane=sane
sap=sap
sapl=sapling
sapphir=sapphires
sarcophagus=sarcophagus
satan=satanic
satchel=satchel
satellit=satellite
satisf=satisfied
savag=savage
save=save
saviour=saviour
savour=savours
saw=sawn
say=say
scabbard=scabbard
scale=scale
scandal=scandal
scant=scanty
scarc=scarcely
scatt=scattered
scene=scene
scent=scented
sceptic=sceptical
sceptr=sceptre
schedul=schedule
scheme=scheme
schism=schism
scholar=scholars
school=school
schoolchild=schoolchildren
scienc=science
scoff=scoff
scope=scope
scorch=scorched
score=score
scorn=scorn
scorpion=scorpions
scoundrel=scoundrel
scourg=scourge
scream=screamed
screw=screws
scribe=scribes
script=script
scriptur=scriptures
scroll=scroll
scrupul=scrupulously
scrutin=scrutiny
se=seer
sea=sea
seaboard=seaboards
seafood=seafood
seal=seal
seam=seamless
search=search
season=season
seat=seat
seced=seceded
seclud=seclusion
second=second
secret=secret
secretar=secretariat
secretarygen=secretary‑general
sect=sect
section=section
sector=sectors
secular=secular
secur=security
sedit=sedition
seduc=seduced
sedul=sedulously
see=see
seed=seed
seek=seek
seem=seem
seeth=seething
segment=segments
seiz=seized
seizur=seizure
seldom=seldom
select=selected
self=self
selfabneg=self‑abnegation
selfaggrandis=self‑aggrandisement
selfappoint=self‑appointed
selfcentr=self‑centred
selfconceit=self‑conceit
selfconsc=self‑conscious
selfcontain=self‑contained
selfcontradictor=self‑contradictory
selfdecept=self‑deception
selfdef=self‑defence
selfden=self‑denial
selfdetermin=self‑determination
selfdisciplin=self‑discipline
selfeffac=self‑effacement
selfevid=self‑evident
selfexpress=self‑expression
selfimpos=self‑imposed
selfindulg=self‑indulgence
selfint=self‑interest
selfish=selfish
selflov=self‑love
selfopinion=self‑opinionated
selfpreserv=self‑preservation
selfre=self‑reliance
selfrenunc=self‑renunciation
selfrestraint=self‑restraint
selfsacrif=self‑sacrificing
selfsacrific=self‑sacrifice
selfsam=self‑same
selfstyl=self‑styled
selfsubsist=self‑subsisting
selfsuffic=self‑sufficient
selfsurrend=self‑surrender
selfwil=self‑willed
sell=sold
semblant=semblance
semen=semen
seminar=seminars
seminari=seminaries
send=sent
senior=senior
sens=sense
sensat=sensations
sensibilit=sensibilities
sensit=sensitive
sensual=sensual
sentent=sentence
sentiment=sentiments
sentinel=sentinels
separ=separation
septemb=september
sepulchr=sepulchre
sequent=sequence
seren=serenity
serious=serious
sermon=sermons
serpent=serpent
serv=service
servant=servants
servil=servile
session=session
set=set
setback=setbacks
settl=settled
settlement=settlement
seven=seven
sevent=seventy
seventeen=seventeen
seventh=seventh
seventyandtwo=seventy‑and‑two
seventyeight=seventy‑eight
seventyf=seventy‑five
seventyfour=seventy‑four
seventyseven=seventy‑seven
seventytwo=seventy‑two
sevenyear=seven‑year
sever=severed
several=several
severe=severe
sex=sex
sexual=sexual
shabb=shabby
shackl=shackles
shade=shade
shades=shades
shadow=shadow
shaft=shafts
shake=shaken
shall=shall
shallow=shallow
shame=shame
shape=shape
share=share
sharp=sharp
shatt=shattered
shave=shaving
she=sheer
shear=shorn
shecamel=she‑camel
shed=shed
sheep=sheep
sheet=sheets
shell=shell
shelt=shelter
shepherd=shepherd
sheserp=she‑serpent
shield=shield
shift=shift
shine=shining
ship=ship
shipment=shipment
shirt=shirts
shock=shock
shoe=shoes
shoot=shot
shop=shop
shore=shores
short=short
shortcom=shortcomings
shortly=shortly
shortsight=short‑sighted
shortterm=short‑term
shoul=shouldst
should=shoulder
shout=shouted
show=show
shower=showers
shrewd=shrewd
shrill=shrill
shrine=shrine
shrink=shrink
shroud=shrouded
shun=shun
shut=shut
sick=sick
side=side
sieg=siege
sift=sifter
sigh=sighs
sight=sight
sign=signs
signal=signal
signatur=signature
signif=signify
signific=significance
silent=silence
silk=silk
silv=silver
silverc=silver‑city
similar=similar
simpl=simple
simplif=simplify
simultan=simultaneously
sin=sins
sinc=since
sincer=sincere
sine=sine
sing=sing
singl=single
singlehand=single‑handed
singlehu=single‑hued
sinist=sinister
sink=sunk
sir=sir
sire=sires
sist=sister
sit=sit
site=site
situat=situated
situation=situation
six=six
sixfold=sixfold
sixt=sixty
sixteen=sixteen
sixth=sixth
sixtynin=sixty‑nine
sixtytwo=sixty‑two
sixyear=six‑year
size=size
sizeabl=sizeable
sketch=sketch
skill=skills
skin=skins
skull=skull
sky=sky
slack=slacken
sland=slander
slash=slashed
slaught=slaughter
slave=slaves
slay=slain
sleep=sleep
sleev=sleeve
slend=slender
slew=slew
slight=slightest
slip=slip
slit=slit
slope=slopes
slough=slough
slow=slow
slum=slums
slumb=slumber
small=small
smear=smeared
smearedwithblood=smeared‑with‑blood
smell=smell
smile=smiling
smirch=smirched
smite=smite
smok=smoking
smoke=smoke
smould=smouldering
snare=snare
snatch=snatched
snow=snow
snowwhit=snow‑white
snuff=snuffed
soak=soaked
soar=soar
sob=sobbing
socal=so‑called
social=social
socialis=socialism
societ=society
societybuild=society‑building
socio=socio
socioeconom=socio‑economic
sociolog=sociology
sociopolit=socio‑political
sodom=sodomy
soft=soft
softflow=soft‑flowing
soil=soil
sojourn=sojourn
solac=solace
solar=solar
soldi=soldiers
sole=sole
solemn=solemn
solicit=solicit
solicitud=solicitude
solid=solid
solidar=solidarity
solitar=solitary
solv=solution
sombr=sombre
some=some
somehow=somehow
someon=someone
someth=something
sometim=sometimes
somewh=somewhere
son=son
soon=soon
sooth=soothing
soothsay=soothsayers
sophist=sophisticated
sorc=sorcery
sordid=sordid
sore=sore
sorelytr=sorely‑tried
soretr=sore‑tried
sorr=sorry
sorrow=sorrow
sorrowladen=sorrow‑laden
sorrowstricken=sorrow‑stricken
sort=sort
soul=soul
soulcrush=soul‑crushing
soulentr=soul‑entrancing
soulrefresh=soul‑refreshing
soulstir=soul‑stirring
sound=sound
soup=soup
sourc=source
south=south
southeastern=southeastern
southw=southwest
sovereign=sovereignty
sow=sow
soy=soy
sp=spying
space=space
spade=spades
span=span
spare=spare
spark=spark
sparkl=sparkling
sparrow=sparrow
spars=sparsely
speak=speak
spear=spears
spearhead=spearhead
spec=species
special=special
specialis=specialised
specif=specific
speck=speck
spectacl=spectacle
spectacular=spectacular
spectrum=spectrum
specul=speculation
speech=speech
speed=speed
spell=spell
spellbound=spellbound
spend=spent
sphere=sphere
spid=spider
spill=spilt
spine=spinal
spirit=spiritual
spiritualist=spiritualists
spit=spat
spite=spite
splendid=splendid
splendour=splendour
split=split
spokes=spokesman
spoliat=spoliation
sponsor=sponsored
spontan=spontaneously
spot=spot
spous=spouse
spread=spread
spring=spring
sprinkl=sprinkling
sprout=sprouted
spur=spur
spurious=spurious
squar=square
srp=srp
stab=stabbed
stabil=stability
stabl=stable
stablish=stablished
staff=staff
stage=stage
stagg=staggering
stagnat=stagnation
stain=stainless
stair=stairs
stake=stake
stalk=stalketh
stallion=stallion
stalwart=stalwart
stamm=stammerer
stand=stand
standard=standard
standardbear=standard‑bearers
standpoint=standpoint
star=stars
starch=starch
stare=stare
start=start
startl=startling
starv=starvation
state=state
stated=stated
stately=stately
statement=statement
statesm=statesmen
station=station
stationar=stationary
statist=statistics
statur=stature
status=status
statut=statutes
staunch=staunch
stay=stay
ste=steer
stead=stead
steadfast=steadfast
steadi=steadily
steal=steals
steamship=steamship
steed=steed
steel=steel
steep=steeped
stem=stem
stench=stench
step=steps
stepfath=stepfather
stereotyp=stereotyped
steril=sterile
stern=stern
steward=stewardship
stifl=stifle
stigma=stigmatised
still=still
stimul=stimulate
sting=sting
stipend=stipend
stir=stirred
stirrup=stirrup
stock=stock
stoke=stoke
stolen=stolen
stomach=stomach
stone=stone
stop=stop
stoppingplac=stopping‑place
stor=story
store=store
storehous=storehouse
storey=storey
storm=storm
stormtoss=storm‑tossed
stout=stout
stoutheart=stout‑hearted
straight=straight
straightway=straightway
strain=strain
strait=straits
strand=strand
strang=strange
stranger=stranger
strangl=strangled
strata=strata
strateg=strategies
straw=straw
stray=strayed
streak=streaks
stream=stream
streamlin=streamlining
street=streets
strength=strength
strenuous=strenuous
stress=stress
stretch=stretched
stricken=stricken
strict=strictly
stride=strides
strife=strife
strike=striking
stringent=stringency
strip=stripped
strive=strive
stroke=stroke
strong=strong
stronghold=stronghold
structur=structure
struggl=struggle
stubborn=stubborn
stud=studded
studi=study
stumbl=stumble
stump=stumps
stun=stunning
stupend=stupendous
stupor=stupor
stygian=stygian
style=style
sub=sub
subarct=subarctic
subcommiss=subcommission
subcontin=subcontinent
subdu=subduing
subject=subject
subjug=subjugated
sublim=sublime
submarin=submarines
submerg=submerged
submiss=submission
submit=submit
subordin=subordinate
subregion=subregions
subscrib=subscribe
subsequ=subsequent
subserv=subservient
subsidiar=subsidiary
subsidis=subsidised
subsist=subsisting
substant=substance
substitut=substitute
subterren=subterranean
subtl=subtle
subunit=subunits
suburb=suburb
subvent=subvention
subvert=subvert
succeed=succeeded
success=success
successiv=successive
successor=successor
succumb=succumbed
suck=sucking
suckl=suckling
sudden=suddenly
suff=suffered
suffic=sufficient
suffus=suffused
sug=suggests
sugar=sugar
suggest=suggestions
suit=suitable
sul=sullied
sulk=sullen
sultan=sultan
sum=sum
summ=summer
summar=summary
summit=summit
summon=summoned
sumptuous=sumptuously
sun=sun
sunbeam=sunbeam
sund=sundered
sundr=sundry
sunlight=sunlight
sunris=sunrise
sunset=sunset
sunshin=sunshine
sup=super
superannu=superannuated
superb=superb
superfic=superficial
superhuman=superhuman
superior=superior
superl=superlative
supern=supernal
supernatur=supernatural
supersed=superseded
superst=super‑state
superstit=superstition
superstructur=superstructure
supp=supply
supplant=supplant
supplement=supplement
suppliant=suppliant
supplic=supplicate
support=support
suppos=supposed
suppress=suppress
supra=supra
supran=supranational
suprem=supreme
sure=surely
surfac=surface
surg=surge
surgic=surgical
surmis=surmised
surmount=surmount
surnam=surnamed
surpass=surpassed
surplus=surplus
surpris=surprising
surrend=surrender
surreptit=surreptitiously
surround=surrounding
surveil=surveillance
survey=survey
surviv=survival
suscept=susceptibilities
suspect=suspected
suspend=suspended
suspense=suspense
suspic=suspicion
sustain=sustained
sway=sway
swear=swear
sweep=swept
sweet=sweet
sweetscent=sweet‑scented
sweetsmel=sweet‑smelling
swell=swelling
swift=swiftly
swiftlyappear=swiftly‑appearing
swim=swim
swing=swing
swoon=swooned
sword=sword
symbol=symbol
symmetr=symmetry
sympath=sympathy
symposium=symposiums
symptom=symptoms
synagogu=synagogues
synchron=synchronised
synops=synopsis
system=system
systemat=systematic
t=tiers
tabernacl=tabernacle
tabl=table
tablet=tablets
tacit=tacit
tact=tact
tail=tail
taint=tainted
take=take
tale=tale
talent=talents
talk=talk
tall=tall
talon=talons
tamp=tampered
tangent=tangent
tangibl=tangible
tantamount=tantamount
tap=tapped
tape=tapes
tare=tares
target=target
tariff=tariffs
tarnish=tarnish
tarr=tarry
task=task
tast=taste
tatt=tattered
taunt=taunts
taxat=taxes
tea=tea
teach=teaching
teacher=teachers
teachings=teachings
team=teams
tear=torn
tearful=tears
technic=technical
techniqu=techniques
technolog=technological
teem=teeming
telegraph=telegraph
telephon=telephone
telescop=telescope
telev=television
tell=told
tem=temerity
temp=tempest
temper=temper
tempera=temperament
temperate=temperate
tempered=tempered
templ=temple
templar=templar
tempo=tempo
tempor=temporal
temporar=temporary
tempt=temptation
ten=ten
tenac=tenaciously
tenant=tenant
tend=tend
tendent=tendency
tender=tender
tenet=tenets
tens=tension
tent=tent
tentat=tentative
tenth=tenth
tenyear=ten‑year
term=terms
termin=termination
terminolog=terminology
terrac=terraces
terrestr=terrestrial
terribl=terrible
terrif=terrified
territor=territories
terror=terror
terrorstricken=terror‑stricken
test=tests
testament=testament
testat=testator
testif=testify
testimon=testimony
text=text
thank=thanks
theatr=theatre
theme=theme
thenc=thence
theocrat=theocracy
theolog=theological
theor=theories
theoret=theoretical
theosoph=theosophists
thereaft=thereafter
thereb=thereby
therefor=therefore
therefrom=therefrom
therein=therein
thereof=thereof
thereon=thereon
thereto=thereto
thereunto=thereunto
thereupon=thereupon
therewith=therewith
thick=thick
thief=theft
thine=thine
thing=things
think=think
third=third
thirst=thirst
thirt=thirty
thirteen=thirteen
thirtyf=thirty‑five
thirtynin=thirty‑nine
thirtyon=thirty‑one
thirtysix=thirty‑six
thirtytwo=thirty‑two
thistl=thistles
thith=thither
thorn=thorns
thorough=thoroughly
though=though
thought=thought
thousand=thousand
thousandfold=thousandfold
thrall=thraldom
thread=thread
threat=threatened
three=three
threefold=threefold
threemonth=three‑month
threescor=three‑score
threestag=three‑stage
threeyear=three‑year
threshold=threshold
thrice=thrice
thrill=thrilling
thrive=thrive
throat=throat
throb=throbbing
throe=throes
throne=throne
throng=thronged
throughout=throughout
throw=thrown
thrust=thrust
thund=thunder
thunderstruck=thunderstruck
thus=thus
thwart=thwart
thyself=thyself
tide=tidings
tie=ties
tig=tigers
tight=tightly
tile=tiles
till=till
time=time
timehonour=time‑honoured
timely=timely
timid=timid
tini=tiny
tire=tireless
titan=titanic
tith=tithes
titl=title
titlede=title‑deeds
tittl=tittle
tobacco=tobacco
today=today
togeth=together
toil=toil
token=tokens
tol=tolerance
toll=toll
tomb=tomb
tomorrow=tomorrow
tone=tone
tongu=tongue
tonight=tonight
tool=tools
tooth=teeth
top=top
topic=topics
toppl=toppled
torch=torch
torchbear=torchbearers
tore=tore
torment=torment
torpedo=torpedo
torpid=torpor
torrent=torrents
torrid=torrid
tortur=torture
torturemong=torture‑mongers
toss=tossed
total=total
totalitarian=totalitarian
tott=tottering
touch=touch
touchston=touchstone
tour=tour
tournament=tournament
tow=towering
toward=towards
town=town
tr=tried
trace=trace
track=tracks
tract=tracts
trade=trade
tradit=traditions
traffic=traffic
traffick=trafficking
tragic=tragic
trail=trail
trailblaz=trailblazers
trailbreak=trailbreakers
train=training
trait=traits
trampl=trampled
tranquil=tranquillity
transact=transactions
transatlant=transatlantic
transcend=transcendent
transcrib=transcribed
transf=transferred
transform=transformation
transgress=transgress
transient=transient
transition=transition
transitor=transitory
translat=translation
translit=transliterated
transluc=translucent
transmigr=transmigrationists
transmit=transmitted
transmut=transmuted
transpar=transparent
transpir=transpired
transport=transported
trap=trappings
travail=travailing
travel=travel
travers=traverse
treach=treacherous
tread=tread
treason=treason
treasur=treasures
treat=treated
treati=treaty
treatis=treatise
trebl=trebling
tree=tree
treestump=tree‑stumps
trembl=tremble
tremend=tremendous
tremul=tremulous
trend=trend
trespass=trespasses
tress=tresses
trial=trials
triangl=triangular
tribe=tribes
tribul=tribulations
tribun=tribunal
tribut=tribute
tricki=tricky
trifl=trifling
trip=trip
tripl=triple
triumph=triumph
trivial=trivial
troop=troops
tropic=tropic
troubl=troubles
trove=trove
truce=truce
true=true
trumpet=trumpet
trumpetblast=trumpet‑blast
trunk=trunk
trust=trust
truste=trustees
trustworth=trustworthiness
truth=truth
truthful=truthfulness
truthseek=truth‑seeker
tuesday=tuesday
tuition=tutorial
tulip=tulips
tumult=tumult
tune=tune
turban=turban
turbul=turbulent
turmoil=turmoil
turn=turn
turningpoint=turning‑point
turquois=turquoises
tutor=tutors
twain=twain
twelfth=twelfth
twelv=twelve
twent=twenty
twentyeight=twenty‑eight
twentyf=twenty‑five
twentyfifth=twenty‑fifth
twentyfirst=twenty‑first
twentyfiveyear=twenty‑five‑year
twentyfour=twenty‑four
twentyon=twenty‑one
twentyseven=twenty‑seven
twentythre=twenty‑three
twentytwo=twenty‑two
twice=twice
twicerep=twice‑repeated
twig=twigs
twin=twin
twinkl=twinkling
two=two
twoedg=two‑edged
twofifth=two‑fifths
twofold=twofold
twohundredyear=two‑hundred‑year
twoprong=two‑pronged
twostag=two‑stage
twostorey=two‑storey
twothird=two‑thirds
twoyear=two‑year
tympanum=tympanum
type=type
tyrant=tyranny
ugli=ugly
ultim=ultimate
un=unerring
unab=unabated
unabash=unabashed
unabl=unable
unacknowledg=unacknowledged
unadult=unadulterated
unaffect=unaffected
unafraid=unafraid
unaid=unaided
unalt=unalterable
unanim=unanimously
unappeas=unappeasable
unapprehend=unapprehended
unapproach=unapproached
unassail=unassailable
unattain=unattainable
unauthent=unauthenticated
unauthor=unauthorised
unavail=unavailable
unavoid=unavoidable
unawar=unaware
unbelief=unbelievers
unbias=unbiased
unborn=unborn
unbreak=unbroken
unbridl=unbridled
unceremon=unceremoniously
uncertain=uncertainty
unchain=unchained
unchalleng=unchallengeable
unchang=unchanged
unchast=unchaste
uncl=uncle
unclean=unclean
unclos=unclosed
uncomfort=uncomfortable
uncommon=uncommon
uncomprom=uncompromising
unconc=unconcealed
uncondit=unconditioned
unconqu=unconquerable
unconsc=unconscious
unconscion=unconscionably
unconstrain=unconstrained
uncontrol=uncontrollable
uncov=uncovered
uncreat=uncreated
uncrit=uncritical
uncultiv=uncultivated
und=underlying
undaunt=undaunted
undefil=undefiled
undeflect=undeflected
under=under
underestim=underestimate
underfoot=underfoot
undergo=undergoing
undergradu=undergraduate
underground=underground
undermin=undermine
underpin=underpinning
underr=underrate
understand=understanding
undertak=undertaken
undesir=undesirable
undet=undeterred
undev=undeviating
undevelop=undeveloped
undi=undying
undim=undimmed
undiminish=undiminished
undismay=undismayed
undisturb=undisturbed
undivid=undivided
undo=undone
undoubt=undoubtedly
undream=undreamt
undreamedof=undreamed‑of
undreamtof=undreamt‑of
undu=undue
unemancip=unemancipated
unemploy=unemployment
unend=unending
unenforc=unenforced
unequ=unequal
unequivoc=unequivocal
unexampl=unexampled
unexcel=unexcelled
unexhaust=unexhausted
unexpect=unexpected
unfad=unfading
unfail=unfailing
unfair=unfair
unfaith=unfaithful
unfalt=unfaltering
unfathom=unfathomed
unfavour=unfavourable
unfeas=unfeasible
unfett=unfettered
unfinish=unfinished
unflinch=unflinching
unfold=unfoldment
unforese=unforeseen
unforgett=unforgettable
unfortun=unfortunate
unfound=unfounded
unfurl=unfurled
ungod=ungodly
ungovern=ungovernable
ungrat=ungrateful
unhamp=unhampered
unhapp=unhappy
unheard=unheard
unheed=unheeded
unhesit=unhesitatingly
unhoist=unhoisted
unhurt=unhurt
unif=unified
uniform=uniformity
unimagin=unimaginable
unimpair=unimpaired
unimpeach=unimpeachable
unimport=unimportant
uninflu=uninfluenced
uninform=uninformed
unintent=unintentionally
uninterrupt=uninterrupted
union=union
uniqu=unique
unit=unity
units=unit
univers=universe
universal=universal
universit=university
unjust=unjust
unjustif=unjustified
unkempt=unkempt
unkind=unkind
unknow=unknown
unlaw=unlawful
unleash=unleashed
unless=unless
unlett=unlettered
unlik=unlike
unlikel=unlikely
unlimit=unlimited
unlock=unlocked
unloos=unloose
unmind=unmindful
unmistak=unmistakable
unmov=unmoved
unnecessar=unnecessary
unnot=unnoticed
unnumb=unnumbered
unobscur=unobscured
unobtrus=unobtrusively
unoffic=unofficial
unpaid=unpaid
unparallel=unparalleled
unperturb=unperturbed
unpleas=unpleasant
unpopular=unpopularity
unpreced=unprecedented
unpredict=unpredictable
unprejud=unprejudiced
unproduct=unproductive
unprofit=unprofitable
unprovok=unprovocative
unpublish=unpublished
unpunish=unpunished
unqualif=unqualified
unquench=unquenchable
unquest=unquestioned
unquestion=unquestionably
unravel=unravel
unre=unreliable
unreason=unreasonable
unrecogn=unrecognised
unrecord=unrecorded
unregen=unregenerate
unrel=unrelenting
unrelax=unrelaxing
unremit=unremitting
unreserv=unreservedly
unrestrain=unrestrained
unrev=unrevealed
unriv=unrivalled
unsaid=unsaid
unsatisf=unsatisfied
unsavour=unsavoury
unschool=unschooled
unscrupul=unscrupulous
unse=unseen
unseal=unsealed
unseem=unseemly
unselfish=unselfish
unshak=unshakeable
unsheath=unsheathed
unsight=unsightly
unspar=unsparing
unspeak=unspeakably
unstil=unstilled
unstint=unstinted
unstop=unstopped
unsubdu=unsubduable
unsul=unsullied
unsupport=unsupported
unsurpass=unsurpassed
unsurrend=unsurrendered
unsuspect=unsuspected
unswerv=unswerving
untaint=untainted
untaught=untaught
unthink=unthinkable
until=untilled
untir=untiring
untold=untold
untoward=untoward
untrammel=untrammelled
untransl=untranslated
untrustworth=untrustworthy
untutor=untutored
unus=unused
unusu=unusual
unveil=unveiled
unwarr=unwarranted
unwarrant=unwarrantable
unwav=unwavering
unwil=unwilling
unwis=unwisdom
unwit=unwittingly
unworth=unworthy
unyield=unyielding
upbuild=upbuilding
upheav=upheaval
uphold=uphold
uplift=uplift
upp=upper
uprais=upraised
upright=upright
uproar=uproar
uproot=uproot
upset=upset
upsurg=upsurge
uptod=up‑to‑date
upward=upward
urban=urban
urg=urge
urgent=urgent
usag=usage
use=use
user=user
ush=ushered
usual=usually
usurp=usurp
util=utilise
utmost=utmost
utopia=utopian
utt=utterance
utterly=utterly
uttermost=uttermost
v=verily
vacat=vacancy
vacil=vacillation
vacuum=vacuum
vagu=vague
vain=vain
vale=vale
valiant=valiant
valid=validity
valley=valley
valour=valour
valu=value
vanguard=vanguard
vanish=vanish
vanquish=vanquished
vapour=vapour
vari=various
vassal=vassal
vast=vast
vault=vault
vaunt=vaunted
veget=vegetable
vehement=vehement
vehicl=vehicle
veil=veil
vein=veins
ven=venerable
venal=venality
vendor=vendor
veng=vengeance
venom=venom
vent=vent
ventur=venture
venu=venue
verac=veracity
verbal=verbal
verdant=verdant
verdict=verdict
verg=verge
verit=verities
vermin=vermin
vermininfest=vermin‑infested
vernal=vernal
vers=verses
versa=versa
version=version
vertebr=vertebrate
very=very
vessel=vessel
vest=vested
vestig=vestige
vestur=vesture
veteran=veteran
vex=vexed
viabl=viable
vibrant=vibrant
vibrat=vibrations
vicar=vicar
vice=vice
viceprem=vice‑premier
vicin=vicinity
vicious=vicious
vicissitud=vicissitudes
victim=victim
victori=victory
vie=vie
view=view
vigil=vigilance
vigour=vigour
vile=vile
vilif=vilification
villag=villages
villain=villainous
vindic=vindicate
vindict=vindictive
vine=vineyard
violat=violation
violent=violence
violet=violet
violin=viol
vip=vipers
virgin=virgin
virtu=virtues
virtual=virtually
virul=virulent
virus=virus
viscount=viscount
visibl=visible
vision=vision
visit=visit
vista=vistas
visual=visualise
vital=vital
vitiat=vitiate
vitup=vituperation
vivid=vividly
vivif=vivifying
vocabular=vocabulary
vocat=vocational
vocif=vociferous
voic=voice
volatil=volatile
volit=volition
volley=volley
volum=volume
volumin=voluminous
volunt=voluntary
vorac=voracious
vortex=vortex
vote=vote
vouchsaf=vouchsafed
vow=vowed
voyag=voyage
vy=vying
waft=wafted
wage=wage
wageearn=wage‑earning
wages=wages
wail=wailing
waist=waist
wait=waiting
wake=wake
walk=walk
wall=walls
wand=wander
wane=waning
want=want
wanton=wanton
war=war
warbl=warble
ward=ward
ware=wares
warehous=warehouse
wari=wary
warm=warm
warn=warning
warp=warp
warravag=war‑ravaged
wartorn=war‑torn
warwear=war‑weary
wash=wash
wast=waste
wat=water
watch=watch
watchword=watchword
watermark=watermark
waterproof=waterproofed
wav=waver
wave=waves
wax=waxed
way=way
wayfar=wayfarer
wayward=wayward
weak=weak
wealth=wealth
wean=weaned
weapon=weapons
wear=wear
weari=weary
weath=weather
weav=weaving
web=web
websit=websites
wed=wedded
weed=weeds
week=weeks
weep=wept
weigh=weigh
weight=weight
wel=welling
welcom=welcome
weld=weld
welfar=welfare
well=well
wellassur=well‑assured
wellb=well‑being
wellbelov=well‑beloved
wellconsid=well‑considered
welldevelop=well‑developed
welldispos=well‑disposed
wellestablish=well‑established
wellfavour=well‑favoured
wellfunct=well‑functioning
wellground=well‑grounded
wellguard=well‑guarded
wellintent=well‑intentioned
wellknown=well‑known
wellnigh=well‑nigh
wellord=well‑ordered
wellorgan=well‑organised
wellpleas=well‑pleasing
wellpolish=well‑polished
wellprepar=well‑prepared
wellspr=wellspring
wellwish=well‑wishers
welt=welter
went=went
wert=wert
west=west
wet=wetness
whale=whales
whatev=whatever
whatsoev=whatsoever
wheat=wheat
whenc=whence
whenev=whenever
whensoev=whensoever
wherea=whereas
whereat=whereat
whereb=whereby
wherefor=wherefore
wherefrom=wherefrom
wherein=wherein
whereof=whereof
whereon=whereon
whereunto=whereunto
whereupon=whereupon
wherev=wherever
wherewith=wherewith
wheth=whether
whey=whey
whilst=whilst
whip=whip
whirl=whirling
whirlpool=whirlpool
whirlwind=whirlwind
whisp=whisperings
white=white
whith=whither
whittl=whittle
whoev=whoever
whole=whole
wholeheart=wholehearted
wholesal=wholesale
wholesom=wholesome
whomev=whomever
whomsoev=whomsoever
whose=whose
whoso=whoso
whosoev=whosoever
wick=wick
wicked=wicked
wide=wide
widen=widening
widerang=wide‑ranging
widespread=widespread
widow=widow
wield=wielded
wife=wife
wil=willing
wild=wilderness
wile=wiles
will=will
willing=willingness
willl=will
wilt=wilt
win=win
wind=winds
windingsheet=winding‑sheet
window=windows
wine=wine
wing=wings
wint=winter
wipe=wiped
wire=wireless
wise=wisdom
wisee=wise
wish=wish
wit=witness
with=withered
withdraw=withdrawn
withhold=withhold
within=within
without=without
withstand=withstand
woe=woe
wolf=wolf
woman=women
womb=womb
won=won
wond=wondrous
wonderful=wonderful
wont=wont
wood=wood
woof=woof
word=words
work=work
workman=workman
workplac=workplace
workshop=workshops
world=world
worldconvuls=world‑convulsing
worlddirect=world‑directing
worldembrac=world‑embracing
worldencircl=world‑encircling
worldencompass=world‑encompassing
worldgirdl=world‑girdling
worldl=worldly
worldlyw=worldly‑wise
worldord=world‑ordering
worldredeem=world‑redeeming
worldsaviour=world‑saviour
worldshak=world‑shaking
worldshap=world‑shaping
worldunif=world‑unifying
worldview=world‑view
worldwid=worldwide
worm=worm
wormlik=worm‑like
worn=worn
wornout=worn‑out
worr=worry
wors=worst
worship=worship
worth=worthy
worthwhil=worthwhile
wouldb=would‑be
wouldst=wouldst
wound=wounds
woven=woven
wrangl=wrangling
wrap=wrapped
wrapt=wrapt
wrath=wrath
wreak=wreak
wreath=wreathed
wreck=wrecker
wrest=wrested
wretch=wretched
wrist=wrist
writ=writ
write=written
writh=writhing
writings=writings
wrong=wronged
wrought=wrought
yard=yards
yea=yea
year=year
yearn=yearning
yearold=year‑old
yellow=yellow
yes=yes
yesterday=yesterday
yet=yet
yield=yield
yoke=yoke
young=young
youth=youth
zeal=zeal
zodiac=zodiac
zone=zone